Geo_FIPS,Geo_QName,population_2020,population_2010,population_2000,population_1990,population_1980,pop_changes,CFS07DDGEO
01001,"Autauga County, Alabama",55639,53155,43671,34222,32259,23380,019
01003,"Baldwin County, Alabama",218289,175791,140415,98280,78556,139733,012
01005,"Barbour County, Alabama",25026,27699,29038,25417,24756,270,019
01007,"Bibb County, Alabama",22374,22610,20826,16576,15723,6651,011
01009,"Blount County, Alabama",57755,56692,51024,39248,36459,21296,011
01011,"Bullock County, Alabama",10173,10923,11714,11042,10596,-423,019
01013,"Butler County, Alabama",19726,20895,21399,21892,21680,-1954,019
01015,"Calhoun County, Alabama",114324,117149,112249,116034,119761,-5437,019
01017,"Chambers County, Alabama",33427,34579,36583,36876,39191,-5764,019
01019,"Cherokee County, Alabama",26035,25700,23988,19543,18760,7275,019
01021,"Chilton County, Alabama",44147,43121,39593,32458,30612,13535,011
01023,"Choctaw County, Alabama",12755,14111,15922,16018,16839,-4084,019
01025,"Clarke County, Alabama",23866,26255,27867,27240,27702,-3836,019
01027,"Clay County, Alabama",13285,14040,14254,13252,13703,-418,019
01029,"Cleburne County, Alabama",14952,14823,14123,12730,12595,2357,019
01031,"Coffee County, Alabama",52238,48349,43615,40240,38533,13705,019
01033,"Colbert County, Alabama",54957,54446,54984,51666,54519,438,019
01035,"Conecuh County, Alabama",12219,13382,14089,14054,15884,-3665,019
01037,"Coosa County, Alabama",10696,11470,12202,11063,11377,-681,019
01039,"Covington County, Alabama",37096,37608,37631,36478,36850,246,019
01041,"Crenshaw County, Alabama",13826,13928,13665,13635,14110,-284,019
01043,"Cullman County, Alabama",83345,79941,77483,67613,61642,21703,011
01045,"Dale County, Alabama",49293,49730,49129,49633,47821,1472,019
01047,"Dallas County, Alabama",38184,44066,46365,48130,53981,-15797,019
01049,"De Kalb County, Alabama",71430,70038,64452,54651,53658,17772,019
01051,"Elmore County, Alabama",81526,77650,65874,49210,43390,38136,019
01053,"Escambia County, Alabama",36775,37996,38440,35518,38440,-1665,019
01055,"Etowah County, Alabama",102721,104066,103459,99840,103057,-336,019
01057,"Fayette County, Alabama",16406,17472,18495,17962,18809,-2403,019
01059,"Franklin County, Alabama",31587,31383,31223,27814,28350,3237,019
01061,"Geneva County, Alabama",26383,26541,25764,23647,24253,2130,019
01063,"Greene County, Alabama",8221,9255,9974,10153,11021,-2800,019
01065,"Hale County, Alabama",14754,16168,17185,15498,15604,-850,019
01067,"Henry County, Alabama",17123,17148,16310,15374,15302,1821,019
01069,"Houston County, Alabama",105319,99029,88787,81331,74632,30687,019
01071,"Jackson County, Alabama",51765,53386,53926,47796,51407,358,019
01073,"Jefferson County, Alabama",658615,656912,662047,651525,671324,-12709,011
01075,"Lamar County, Alabama",13854,14743,15904,15715,16453,-2599,019
01077,"Lauderdale County, Alabama",92870,91762,87966,79661,80546,12324,019
01079,"Lawrence County, Alabama",32969,34235,34803,31513,30170,2799,019
01081,"Lee County, Alabama",163461,135010,115092,87146,76283,87178,019
01083,"Limestone County, Alabama",96921,78614,65676,54135,46005,50916,019
01085,"Lowndes County, Alabama",9936,11731,13473,12658,13253,-3317,019
01087,"Macon County, Alabama",18437,21699,24105,24928,26829,-8392,019
01089,"Madison County, Alabama",367686,323080,276700,238912,196966,170720,019
01091,"Marengo County, Alabama",19138,21296,22539,23084,25047,-5909,019
01093,"Marion County, Alabama",29818,30792,31214,29830,30041,-223,019
01095,"Marshall County, Alabama",96137,90867,82231,70832,65622,30515,019
01097,"Mobile County, Alabama",413977,408620,399843,378643,364980,48997,012
01099,"Monroe County, Alabama",21006,23329,24324,23968,22651,-1645,019
01101,"Montgomery County, Alabama",226451,228018,223510,209085,197038,29413,019
01103,"Morgan County, Alabama",119352,117632,111064,100043,90231,29121,019
01105,"Perry County, Alabama",9104,10684,11861,12759,15012,-5908,019
01107,"Pickens County, Alabama",20049,19917,20949,20699,21481,-1432,019
01109,"Pike County, Alabama",33274,32147,29605,27595,28050,5224,019
01111,"Randolph County, Alabama",22732,22817,22380,19881,20075,2657,019
01113,"Russell County, Alabama",57938,51663,49756,46860,47356,10582,019
01115,"St. Clair County, Alabama",88929,80658,64742,50009,41205,47724,011
01117,"Shelby County, Alabama",216350,187880,143293,99358,66298,150052,011
01119,"Sumter County, Alabama",12595,13871,14798,16174,16908,-4313,019
01121,"Talladega County, Alabama",80244,82347,80321,74107,73826,6418,019
01123,"Tallapoosa County, Alabama",40450,41534,41475,38826,38676,1774,019
01125,"Tuscaloosa County, Alabama",208854,188331,164875,150522,137541,71313,019
01127,"Walker County, Alabama",63802,67612,70713,67670,68660,-4858,011
01129,"Washington County, Alabama",16336,17556,18097,16694,16821,-485,019
01131,"Wilcox County, Alabama",10552,12012,13183,13568,14755,-4203,019
01133,"Winston County, Alabama",23712,24687,24843,22053,21953,1759,019
04001,"Apache County, Arizona",71714,70312,69423,61591,52108,19606,049
04003,"Cochise County, Arizona",126442,129268,117755,97624,85686,40756,049
04005,"Coconino County, Arizona",142254,131824,116320,96591,75008,67246,049
04007,"Gila County, Arizona",53846,53272,51335,40216,37080,16766,049
04009,"Graham County, Arizona",38304,36030,33489,26554,22862,15442,049
04011,"Greenlee County, Arizona",9465,8318,8547,8008,11406,-1941,049
04013,"Maricopa County, Arizona",4412779,3751410,3072149,2122101,1509052,2903727,041
04015,"Mohave County, Arizona",210998,199177,155032,93497,55865,155133,049
04017,"Navajo County, Arizona",110271,107060,97470,77658,67629,42642,049
04019,"Pima County, Arizona",1038476,964462,843746,666880,531443,507033,042
04021,"Pinal County, Arizona",447559,329297,179727,116379,90918,356641,041
04023,"Santa Cruz County, Arizona",46594,46051,38381,29676,20459,26135,049
04025,"Yavapai County, Arizona",232396,209260,167517,107714,68145,164251,049
04027,"Yuma County, Arizona",211931,190526,160026,106895,90554,121377,049
05001,"Arkansas County, Arkansas",17761,19321,20749,21653,24175,-6414,050
05003,"Ashley County, Arkansas",20000,22126,24209,24319,26538,-6538,050
05005,"Baxter County, Arkansas",41673,41388,38386,31186,27409,14264,050
05007,"Benton County, Arkansas",273510,209911,153406,97499,78115,195395,050
05009,"Boone County, Arkansas",37525,36710,33948,28297,26067,11458,050
05011,"Bradley County, Arkansas",10805,11638,12600,11793,13803,-2998,050
05013,"Calhoun County, Arkansas",5160,5529,5744,5826,6079,-919,050
05015,"Carroll County, Arkansas",28062,26971,25357,18654,16203,11859,050
05017,"Chicot County, Arkansas",10433,12102,14117,15713,17793,-7360,050
05019,"Clark County, Arkansas",22341,23083,23546,21437,23326,-985,050
05021,"Clay County, Arkansas",14710,16297,17609,18107,20616,-5906,050
05023,"Cleburne County, Arkansas",25063,25692,24046,19411,16909,8154,050
05025,"Cleveland County, Arkansas",8063,8769,8571,7781,7868,195,050
05027,"Columbia County, Arkansas",23620,24756,25603,25691,26644,-3024,050
05029,"Conway County, Arkansas",20895,21059,20336,19151,19505,1390,050
05031,"Craighead County, Arkansas",109081,93329,82148,68956,63239,45842,050
05033,"Crawford County, Arkansas",63118,60778,53247,42493,36892,26226,050
05035,"Crittenden County, Arkansas",48381,50673,50866,49939,49499,-1118,050
05037,"Cross County, Arkansas",16576,18144,19526,19225,20434,-3858,050
05039,"Dallas County, Arkansas",7114,8280,9210,9614,10515,-3401,050
05041,"Desha County, Arkansas",11538,13351,15341,16798,19760,-8222,050
05043,"Drew County, Arkansas",18263,18546,18723,17369,17910,353,050
05045,"Faulkner County, Arkansas",124800,108375,86014,60006,46192,78608,050
05047,"Franklin County, Arkansas",17785,18176,17771,14897,14705,3080,050
05049,"Fulton County, Arkansas",12301,12263,11642,10037,9975,2326,050
05051,"Garland County, Arkansas",99043,95290,88068,73397,70531,28512,050
05053,"Grant County, Arkansas",18229,17657,16464,13948,13008,5221,050
05055,"Greene County, Arkansas",45197,41318,37331,31804,30744,14453,050
05057,"Hempstead County, Arkansas",21695,22747,23587,21621,23635,-1940,050
05059,"Hot Spring County, Arkansas",33667,32671,30353,26115,26819,6848,050
05061,"Howard County, Arkansas",13267,13778,14300,13569,13459,-192,050
05063,"Independence County, Arkansas",37585,35994,34233,31192,30147,7438,050
05065,"Izard County, Arkansas",13596,13636,13249,11364,10768,2828,050
05067,"Jackson County, Arkansas",16908,18015,18418,18944,21646,-4738,050
05069,"Jefferson County, Arkansas",68123,78447,84278,85487,90718,-22595,050
05071,"Johnson County, Arkansas",26475,25180,22781,18221,17423,9052,050
05073,"Lafayette County, Arkansas",6728,7764,8559,9643,10213,-3485,050
05075,"Lawrence County, Arkansas",16511,17340,17774,17457,18447,-1936,050
05077,"Lee County, Arkansas",8963,10709,12580,13053,15539,-6576,050
05079,"Lincoln County, Arkansas",13278,14203,14492,13690,13369,-91,050
05081,"Little River County, Arkansas",12345,13145,13628,13966,13952,-1607,050
05083,"Logan County, Arkansas",21619,22580,22486,20557,20144,1475,050
05085,"Lonoke County, Arkansas",73163,65846,52828,39268,34518,38645,050
05087,"Madison County, Arkansas",16393,15507,14243,11618,11373,5020,050
05089,"Marion County, Arkansas",16586,16779,16140,12001,11334,5252,050
05091,"Miller County, Arkansas",43515,43048,40443,38467,37766,5749,050
05093,"Mississippi County, Arkansas",41396,46815,51979,57525,59517,-18121,050
05095,"Monroe County, Arkansas",6879,8492,10254,11333,14052,-7173,050
05097,"Montgomery County, Arkansas",8964,9490,9245,7841,7771,1193,050
05099,"Nevada County, Arkansas",8249,9149,9955,10101,11097,-2848,050
05101,"Newton County, Arkansas",7753,8394,8608,7666,7756,-3,050
05103,"Ouachita County, Arkansas",23597,26293,28790,30574,30541,-6944,050
05105,"Perry County, Arkansas",10342,10435,10209,7969,7266,3076,050
05107,"Phillips County, Arkansas",18151,22412,26445,28838,34772,-16621,050
05109,"Pike County, Arkansas",10714,11286,11303,10086,10373,341,050
05111,"Poinsett County, Arkansas",23747,24703,25614,24664,27032,-3285,050
05113,"Polk County, Arkansas",19999,20490,20229,17347,17007,2992,050
05115,"Pope County, Arkansas",63926,60460,54469,45883,39021,24905,050
05117,"Prairie County, Arkansas",8138,8839,9539,9518,10140,-2002,050
05119,"Pulaski County, Arkansas",393078,377060,361474,349660,340613,52465,050
05121,"Randolph County, Arkansas",17934,18049,18195,16558,16834,1100,050
05123,"St. Francis County, Arkansas",25477,28302,29329,28497,30858,-5381,050
05125,"Saline County, Arkansas",120990,102439,83529,64183,53161,67829,050
05127,"Scott County, Arkansas",10269,11226,10996,10205,9685,584,050
05129,"Searcy County, Arkansas",7898,8227,8261,7841,8847,-949,050
05131,"Sebastian County, Arkansas",127670,123847,115071,99590,95172,32498,050
05133,"Sevier County, Arkansas",16947,16636,15757,13637,14060,2887,050
05135,"Sharp County, Arkansas",17217,17432,17119,14109,14607,2610,050
05137,"Stone County, Arkansas",12582,12321,11499,9775,9022,3560,050
05139,"Union County, Arkansas",39089,42180,45629,46719,48573,-9484,050
05141,"Van Buren County, Arkansas",16578,17237,16192,14008,13357,3221,050
05143,"Washington County, Arkansas",236198,197192,157715,113409,100494,135704,050
05145,"White County, Arkansas",78725,74957,67165,54676,50835,27890,050
05147,"Woodruff County, Arkansas",6477,7505,8741,9520,11222,-4745,050
05149,"Yell County, Arkansas",21425,21895,21139,17759,17026,4399,050
06001,"Alameda County, California",1661584,1477980,1443741,1279182,1105379,556205,064
06003,"Alpine County, California",1159,1176,1208,1113,1097,62,069
06005,"Amador County, California",39023,38327,35100,30039,19314,19709,069
06007,"Butte County, California",223344,218635,203171,182120,143851,79493,069
06009,"Calaveras County, California",45828,45994,40554,31998,20710,25118,069
06011,"Colusa County, California",21491,21165,18804,16275,12791,8700,069
06013,"Contra Costa County, California",1147788,1024809,948816,803732,656380,491408,064
06015,"Del Norte County, California",27692,28471,27507,23460,18217,9475,069
06017,"El Dorado County, California",190345,179053,156299,125995,85812,104533,062
06019,"Fresno County, California",990204,908830,799407,667490,514621,475583,069
06021,"Glenn County, California",28060,27935,26453,24798,21350,6710,069
06023,"Humboldt County, California",136101,133058,126518,119118,108514,27587,069
06025,"Imperial County, California",180580,168052,142361,109303,92110,88470,069
06027,"Inyo County, California",17930,18434,17945,18281,17895,35,069
06029,"Kern County, California",892458,815693,661645,543477,403089,489369,069
06031,"Kings County, California",151090,151122,129461,101469,73738,77352,069
06033,"Lake County, California",64276,64371,58309,50631,36366,27910,069
06035,"Lassen County, California",30600,35081,33828,27598,21661,8939,069
06037,"Los Angeles County, California",10040682,9758256,9519338,8863164,7477503,2563179,061
06039,"Madera County, California",155925,147738,123109,88090,63116,92809,069
06041,"Marin County, California",259441,248601,247289,230096,222568,36873,064
06043,"Mariposa County, California",17319,18290,17130,14302,11108,6211,069
06045,"Mendocino County, California",87110,87487,86265,80345,66738,20372,069
06047,"Merced County, California",273661,250699,210554,178403,134560,139101,069
06049,"Modoc County, California",8853,9605,9449,9678,8610,243,069
06051,"Mono County, California",14395,13905,12853,9956,8577,5818,069
06053,"Monterey County, California",432977,407435,401762,355660,290444,142533,069
06055,"Napa County, California",138572,134051,124279,110765,99199,39373,064
06057,"Nevada County, California",99417,98186,92033,78510,51645,47772,062
06059,"Orange County, California",3170345,2965525,2846289,2410556,1932709,1237636,061
06061,"Placer County, California",391799,336477,248399,172796,117247,274552,062
06063,"Plumas County, California",18844,20392,20824,19739,17340,1504,069
06065,"Riverside County, California",2437864,2109464,1545387,1170413,663166,1774698,061
06067,"Sacramento County, California",1537948,1395144,1223499,1041219,783381,754567,062
06069,"San Benito County, California",61547,54492,53234,36697,25005,36542,064
06071,"San Bernardino County, California",2162532,2005287,1709434,1418380,895016,1267516,061
06073,"San Diego County, California",3323970,3022468,2813833,2498016,1861846,1462124,063
06075,"San Francisco County, California",874784,789172,776733,723959,678974,195810,064
06077,"San Joaquin County, California",751615,673613,563598,480628,347342,404273,069
06079,"San Luis Obispo County, California",282517,265577,246681,217162,155435,127082,069
06081,"San Mateo County, California",765623,704327,707161,649623,587329,178294,064
06083,"Santa Barbara County, California",444895,416051,399347,369608,298694,146201,069
06085,"Santa Clara County, California",1924379,1739396,1682585,1497577,1295071,629308,064
06087,"Santa Cruz County, California",273170,256901,255602,229734,188141,85029,064
06089,"Shasta County, California",179267,176906,163256,147036,115715,63552,069
06091,"Sierra County, California",2898,3366,3555,3318,3073,-175,069
06093,"Siskiyou County, California",43516,44690,44301,43531,39732,3784,069
06095,"Solano County, California",444538,410042,394542,340421,235203,209335,064
06097,"Sonoma County, California",496801,474047,458614,388222,299681,197120,064
06099,"Stanislaus County, California",546235,509682,446997,370522,265900,280335,069
06101,"Sutter County, California",96315,93420,78930,64415,52246,44069,062
06103,"Tehama County, California",64176,62575,56039,49625,38888,25288,069
06105,"Trinity County, California",12541,13701,13022,13063,11858,683,069
06107,"Tulare County, California",463955,429404,368021,311921,245738,218217,069
06109,"Tuolumne County, California",54147,56074,54501,48456,33928,20219,069
06111,"Ventura County, California",845599,809080,753197,669016,529174,316425,061
06113,"Yolo County, California",218774,196418,168660,141092,113374,105400,062
06115,"Yuba County, California",77524,71160,60219,58228,49733,27791,062
08001,"Adams County, Colorado",509844,425330,363857,265038,245944,263900,081
08003,"Alamosa County, Colorado",16153,15293,14966,13617,11799,4354,089
08005,"Arapahoe County, Colorado",649980,552860,487967,391511,293621,356359,081
08007,"Archuleta County, Colorado",13588,12136,9898,5345,3664,9924,089
08009,"Baca County, Colorado",3570,3833,4517,4556,5419,-1849,089
08011,"Bent County, Colorado",5677,6125,5998,5048,5945,-268,089
08013,"Boulder County, Colorado",324682,290177,291288,225339,189625,135057,081
08015,"Chaffee County, Colorado",19977,17540,16242,12684,13227,6750,089
08017,"Cheyenne County, Colorado",1999,2194,2231,2397,2153,-154,089
08019,"Clear Creek County, Colorado",9533,9088,9322,7619,7308,2225,081
08021,"Conejos County, Colorado",8130,8220,8400,7453,7794,336,089
08023,"Costilla County, Colorado",3810,3536,3663,3190,3071,739,089
08025,"Crowley County, Colorado",5733,5897,5518,3946,2988,2745,089
08027,"Custer County, Colorado",4941,3899,3503,1926,1528,3413,089
08029,"Delta County, Colorado",30758,30533,27834,20980,21225,9533,089
08031,"Denver County, Colorado",715878,578087,554636,467610,492365,223513,081
08033,"Dolores County, Colorado",1896,2027,1844,1504,1658,238,089
08035,"Douglas County, Colorado",344280,273440,175766,60391,25153,319127,081
08037,"Eagle County, Colorado",54960,50793,41659,21928,13320,41640,089
08039,"Elbert County, Colorado",26230,22712,19872,9646,6850,19380,081
08041,"El Paso County, Colorado",710499,599988,516929,397014,309424,401075,089
08043,"Fremont County, Colorado",47725,46941,46145,32273,28676,19049,089
08045,"Garfield County, Colorado",59605,54761,43791,29974,22514,37091,089
08047,"Gilpin County, Colorado",6108,5126,4757,3070,2441,3667,081
08049,"Grand County, Colorado",15536,14526,12442,7966,7475,8061,089
08051,"Gunnison County, Colorado",17119,15136,13956,10273,10689,6430,089
08053,"Hinsdale County, Colorado",781,489,790,467,408,373,089
08055,"Huerfano County, Colorado",6769,6948,7862,6009,6440,329,089
08057,"Jackson County, Colorado",1316,1464,1577,1605,1863,-547,089
08059,"Jefferson County, Colorado",578795,528614,527056,438430,371753,207042,081
08061,"Kiowa County, Colorado",1463,1643,1622,1688,1936,-473,089
08063,"Kit Carson County, Colorado",7246,8156,8011,7140,7599,-353,089
08065,"Lake County, Colorado",7845,7039,7812,6007,8830,-985,089
08067,"La Plata County, Colorado",56138,50149,43941,32284,27424,28714,089
08069,"Larimer County, Colorado",350523,291162,251494,186136,149184,201339,089
08071,"Las Animas County, Colorado",14323,15675,15207,13765,14897,-574,089
08073,"Lincoln County, Colorado",5608,5476,6087,4529,4663,945,089
08075,"Logan County, Colorado",22282,22278,20504,17567,19800,2482,089
08077,"Mesa County, Colorado",152962,142284,116255,93145,81530,71432,089
08079,"Mineral County, Colorado",853,1020,831,558,804,49,089
08081,"Moffat County, Colorado",13150,13519,13184,11357,13133,17,089
08083,"Montezuma County, Colorado",26266,25279,23830,18672,16510,9756,089
08085,"Montrose County, Colorado",42280,40266,33432,24423,24352,17928,089
08087,"Morgan County, Colorado",28617,27911,27171,21939,22513,6104,089
08089,"Otero County, Colorado",18284,18830,20311,20185,22567,-4283,089
08091,"Ouray County, Colorado",4890,4319,3742,2295,1925,2965,089
08093,"Park County, Colorado",18345,16286,14523,7174,5333,13012,081
08095,"Phillips County, Colorado",4343,4394,4480,4189,4542,-199,089
08097,"Pitkin County, Colorado",17980,16389,14872,12661,10338,7642,089
08099,"Prowers County, Colorado",12035,12734,14483,13347,13070,-1035,089
08101,"Pueblo County, Colorado",167412,156244,141472,123051,125972,41440,089
08103,"Rio Blanco County, Colorado",6369,6494,5986,5972,6255,114,089
08105,"Rio Grande County, Colorado",11300,11926,12413,10770,10511,789,089
08107,"Routt County, Colorado",25317,22924,19690,14088,13404,11913,089
08109,"Saguache County, Colorado",6730,6161,5917,4619,3935,2795,089
08111,"San Juan County, Colorado",646,752,558,745,833,-187,089
08113,"San Miguel County, Colorado",8110,7299,6594,3653,3192,4918,089
08115,"Sedgwick County, Colorado",2306,2412,2747,2690,3266,-960,089
08117,"Summit County, Colorado",30735,27105,23548,12881,8848,21887,089
08119,"Teller County, Colorado",24981,22821,20555,12468,8034,16947,089
08121,"Washington County, Colorado",4869,4773,4926,4812,5304,-435,089
08123,"Weld County, Colorado",315389,242860,180936,131821,123438,191951,081
08125,"Yuma County, Colorado",10013,9896,9841,8954,9682,331,089
09001,"Fairfield County, Connecticut",944306,905342,882567,827645,807143,137163,092
09003,"Hartford County, Connecticut",892153,887976,857183,851783,807766,84387,091
09005,"Litchfield County, Connecticut",181143,189916,182193,174092,156769,24374,092
09007,"Middlesex County, Connecticut",162742,164774,155071,143196,129017,33725,091
09009,"New Haven County, Connecticut",855733,856688,824008,804219,761337,94396,092
09011,"New London County, Connecticut",266868,272360,259088,254957,238409,28459,099
09013,"Tolland County, Connecticut",150947,151073,136364,128699,114823,36124,091
09015,"Windham County, Connecticut",116657,117708,109091,102525,92312,24345,091
10001,"Kent County, Delaware",179124,156918,126697,110993,98219,80905,100
10003,"New Castle County, Delaware",558306,533514,500265,441946,398115,160191,100
10005,"Sussex County, Delaware",230249,190846,156638,113229,98004,132245,100
11001,"District Of Columbia, District Of Columbia",701974,584400,572059,606900,638333,63641,111
12001,"Alachua County, Florida",268105,244247,217955,181596,151348,116757,129
12003,"Baker County, Florida",28679,26548,22259,18486,15289,13390,121
12005,"Bay County, Florida",180076,166798,148217,126994,97740,82336,129
12007,"Bradford County, Florida",27723,28750,26088,22515,20023,7700,129
12009,"Brevard County, Florida",594001,540583,476230,398978,272959,321042,129
12011,"Broward County, Florida",1942273,1734139,1623018,1255488,1018200,924073,122
12013,"Calhoun County, Florida",14324,14372,13017,11011,9294,5030,129
12015,"Charlotte County, Florida",185926,159385,141627,110975,58460,127466,129
12017,"Citrus County, Florida",147938,140686,118085,93515,54703,93235,129
12019,"Clay County, Florida",215294,186076,140814,105986,67052,148242,121
12021,"Collier County, Florida",379345,316931,251377,152099,85971,293374,129
12023,"Columbia County, Florida",70898,66964,56513,42613,35399,35499,129
12027,"De Soto County, Florida",37371,34557,32209,23865,19039,18332,129
12029,"Dixie County, Florida",16740,16196,13827,10585,7751,8989,129
12031,"Duval County, Florida",948651,854848,778879,672971,571003,377648,121
12033,"Escambia County, Florida",316691,297940,294410,262798,233794,82897,129
12035,"Flagler County, Florida",112854,91806,49832,28701,10913,101941,123
12037,"Franklin County, Florida",11914,11470,11057,8967,7661,4253,129
12039,"Gadsden County, Florida",45787,46031,45087,41105,41565,4222,129
12041,"Gilchrist County, Florida",18245,16683,14437,9667,5767,12478,129
12043,"Glades County, Florida",13777,12617,10576,7591,5992,7785,129
12045,"Gulf County, Florida",15073,15879,13332,11504,10658,4415,129
12047,"Hamilton County, Florida",14397,14696,13327,10930,8761,5636,129
12049,"Hardee County, Florida",27027,27521,26938,19499,19379,7648,129
12051,"Hendry County, Florida",41472,39030,36210,25773,18599,22873,129
12053,"Hernando County, Florida",190700,170337,130802,101115,44469,146231,124
12055,"Highlands County, Florida",104574,98807,87366,68432,47526,57048,129
12057,"Hillsborough County, Florida",1451358,1200236,998948,834054,646960,804398,124
12059,"Holmes County, Florida",19530,19992,18564,15778,14723,4807,129
12061,"Indian River County, Florida",156964,135518,112947,90208,59896,97068,129
12063,"Jackson County, Florida",47409,49334,46755,41375,39154,8255,129
12065,"Jefferson County, Florida",14278,14583,12902,11296,10703,3575,129
12067,"Lafayette County, Florida",8576,8506,7022,5578,4035,4541,129
12069,"Lake County, Florida",356115,291671,210528,152104,104870,251245,123
12071,"Lee County, Florida",756570,606165,440888,335113,205266,551304,129
12073,"Leon County, Florida",291863,270409,239452,192493,148655,143208,129
12075,"Levy County, Florida",40979,40415,34450,25923,19870,21109,129
12077,"Liberty County, Florida",8333,8230,7021,5569,4260,4073,129
12079,"Madison County, Florida",18557,19300,18733,16569,14894,3663,129
12081,"Manatee County, Florida",393847,318619,264002,211707,148442,245405,129
12083,"Marion County, Florida",360210,326833,258916,194833,122488,237722,129
12085,"Martin County, Florida",160420,144322,126731,100900,64014,96406,129
12087,"Monroe County, Florida",75137,73065,79589,78024,63188,11949,129
12089,"Nassau County, Florida",85762,71099,57663,43941,32894,52868,121
12091,"Okaloosa County, Florida",207430,182076,170498,143776,109920,97510,129
12093,"Okeechobee County, Florida",41611,39883,35910,29627,20264,21347,129
12095,"Orange County, Florida",1373784,1116094,896344,677491,471016,902768,123
12097,"Osceola County, Florida",363666,258531,172493,107728,49287,314379,123
12099,"Palm Beach County, Florida",1482057,1299356,1131184,863518,576863,905194,122
12101,"Pasco County, Florida",539885,456514,344765,281131,193643,346242,124
12103,"Pinellas County, Florida",970985,918263,921482,851659,728531,242454,124
12105,"Polk County, Florida",705735,590116,483924,405382,321652,384083,129
12107,"Putnam County, Florida",73784,74715,70423,65070,50549,23235,129
12109,"St. Johns County, Florida",255410,180624,123135,83829,51303,204107,121
12111,"St. Lucie County, Florida",320914,269659,192695,150171,87182,233732,129
12113,"Santa Rosa County, Florida",179587,147838,117743,81608,55988,123599,129
12115,"Sarasota County, Florida",427766,376200,325957,277776,202251,225515,129
12117,"Seminole County, Florida",466695,417330,365196,287529,179752,286943,123
12119,"Sumter County, Florida",129938,85891,53345,31577,24272,105666,123
12121,"Suwannee County, Florida",44290,40675,34844,26780,22287,22003,129
12123,"Taylor County, Florida",21709,22000,19256,17111,16532,5177,129
12125,"Union County, Florida",15282,15375,13442,10252,10166,5116,129
12127,"Volusia County, Florida",546107,496053,443343,370712,258762,287345,123
12129,"Wakulla County, Florida",32855,29368,22863,14202,10887,21968,129
12131,"Walton County, Florida",71049,53366,40601,27760,21300,49749,129
12133,"Washington County, Florida",25094,24125,20973,16919,14509,10585,129
13001,"Appling County, Georgia",18428,18050,17419,15744,15565,2863,139
13003,"Atkinson County, Georgia",8311,8332,7609,6213,6141,2170,139
13005,"Bacon County, Georgia",11140,10969,10103,9566,9379,1761,139
13007,"Baker County, Georgia",3090,3657,4074,3615,3808,-718,139
13009,"Baldwin County, Georgia",45072,46905,44700,39530,34686,10386,139
13011,"Banks County, Georgia",18900,17840,14422,10308,8702,10198,139
13013,"Barrow County, Georgia",81294,66359,46144,29721,21354,59940,131
13015,"Bartow County, Georgia",106456,97423,76019,55911,40760,65696,131
13017,"Ben Hill County, Georgia",16889,17631,17484,16245,16000,889,139
13019,"Berrien County, Georgia",19206,18708,16235,14153,13525,5681,139
13021,"Bibb County, Georgia",153026,154810,153887,149967,150256,2770,139
13023,"Bleckley County, Georgia",12870,12937,11666,10430,10767,2103,139
13025,"Brantley County, Georgia",18924,17650,14629,11077,8701,10223,139
13027,"Brooks County, Georgia",15548,16338,16450,15398,15255,293,139
13029,"Bryan County, Georgia",38321,29039,23417,15438,10175,28146,132
13031,"Bulloch County, Georgia",77719,67298,55983,43125,35785,41934,139
13033,"Burke County, Georgia",22567,23083,22243,20579,19349,3218,139
13035,"Butts County, Georgia",24463,23401,19522,15326,13665,10798,131
13037,"Calhoun County, Georgia",6301,6488,6320,5013,5717,584,139
13039,"Camden County, Georgia",53960,49293,43664,30167,13371,40589,139
13043,"Candler County, Georgia",10834,10715,9577,7744,7518,3316,139
13045,"Carroll County, Georgia",118692,109227,87268,71422,56346,62346,131
13047,"Catoosa County, Georgia",67181,62951,53282,42464,36991,30190,139
13049,"Charlton County, Georgia",13032,12310,10282,8496,7343,5689,139
13051,"Chatham County, Georgia",289649,256428,232048,216935,202226,87423,132
13053,"Chattahoochee County, Georgia",10470,11702,14882,16934,21732,-11262,139
13055,"Chattooga County, Georgia",24826,25985,25470,22242,21856,2970,139
13057,"Cherokee County, Georgia",253780,206283,141903,90204,51699,202081,131
13059,"Clarke County, Georgia",126952,115070,101489,87594,74498,52454,139
13061,"Clay County, Georgia",2931,2981,3357,3364,3553,-622,139
13063,"Clayton County, Georgia",287560,260156,236517,182052,150357,137203,131
13065,"Clinch County, Georgia",6648,6841,6878,6160,6660,-12,139
13067,"Cobb County, Georgia",756653,677402,607751,447745,297718,458935,131
13069,"Coffee County, Georgia",43070,41647,37413,29592,26894,16176,139
13071,"Colquitt County, Georgia",45510,44712,42053,36645,35376,10134,139
13073,"Columbia County, Georgia",154257,117858,89288,66031,40118,114139,139
13075,"Cook County, Georgia",17217,16976,15771,13456,13490,3727,139
13077,"Coweta County, Georgia",145839,121528,89215,53853,39268,106571,131
13079,"Crawford County, Georgia",12267,12821,12495,8991,7684,4583,139
13081,"Crisp County, Georgia",22509,23182,21996,20011,19489,3020,139
13083,"Dade County, Georgia",16183,16595,15154,13147,12318,3865,139
13085,"Dawson County, Georgia",25277,21758,15999,9429,4774,20503,131
13087,"Decatur County, Georgia",26595,27920,28240,25511,25495,1100,139
13089,"De Kalb County, Georgia",755287,685371,665865,545837,483024,272263,131
13091,"Dodge County, Georgia",20725,21402,19171,17607,16955,3770,139
13093,"Dooly County, Georgia",13571,14283,11525,9901,10826,2745,139
13095,"Dougherty County, Georgia",88696,94514,96065,96311,100718,-12022,139
13097,"Douglas County, Georgia",145063,127800,92174,71120,54573,90490,131
13099,"Early County, Georgia",10218,11286,12354,11854,13158,-2940,139
13101,"Echols County, Georgia",3944,3973,3754,2334,2297,1647,139
13103,"Effingham County, Georgia",62241,50513,37535,25687,18327,43914,132
13105,"Elbert County, Georgia",19164,20421,20511,18949,18758,406,139
13107,"Emanuel County, Georgia",22525,22348,21837,20546,20795,1730,139
13109,"Evans County, Georgia",10671,10966,10495,8724,8428,2243,139
13111,"Fannin County, Georgia",25797,23337,19798,15992,14748,11049,139
13113,"Fayette County, Georgia",113544,105344,91263,62415,29043,84501,131
13115,"Floyd County, Georgia",97805,95810,90565,81251,79800,18005,139
13117,"Forsyth County, Georgia",236605,163885,98407,44083,27958,208647,131
13119,"Franklin County, Georgia",23015,22121,20285,16650,15185,7830,139
13121,"Fulton County, Georgia",1051550,886982,816006,648951,589904,461646,131
13123,"Gilmer County, Georgia",30986,28076,23456,13368,11110,19876,139
13125,"Glascock County, Georgia",2984,3007,2556,2357,2382,602,139
13127,"Glynn County, Georgia",85008,77632,67568,62496,54981,30027,139
13129,"Gordon County, Georgia",57756,54059,44104,35072,30070,27686,139
13131,"Grady County, Georgia",24693,24738,23659,20279,19845,4848,139
13133,"Greene County, Georgia",17808,15844,14406,11793,11391,6417,139
13135,"Gwinnett County, Georgia",926414,778022,588448,352910,166903,759511,131
13137,"Habersham County, Georgia",45204,42212,35902,27621,25020,20184,139
13139,"Hall County, Georgia",201434,175001,139277,95428,75649,125785,131
13141,"Hancock County, Georgia",8500,9649,10076,8908,9466,-966,139
13143,"Haralson County, Georgia",29608,28574,25690,21966,18422,11186,131
13145,"Harris County, Georgia",34676,30807,23695,17788,15464,19212,139
13147,"Hart County, Georgia",25981,25024,22997,19712,18585,7396,139
13149,"Heard County, Georgia",11785,11720,11012,8628,6520,5265,131
13151,"Henry County, Georgia",229994,193717,119341,58741,36309,193685,131
13153,"Houston County, Georgia",155317,134880,110765,89208,77605,77712,139
13155,"Irwin County, Georgia",9379,9642,9931,8649,8988,391,139
13157,"Jackson County, Georgia",70467,58347,41589,30005,25343,45124,139
13159,"Jasper County, Georgia",14074,13695,11426,8453,7553,6521,131
13161,"Jeff Davis County, Georgia",15063,14558,12684,12032,11473,3590,139
13163,"Jefferson County, Georgia",15489,16919,17266,17408,18403,-2914,139
13165,"Jenkins County, Georgia",8787,8400,8575,8247,8841,-54,139
13167,"Johnson County, Georgia",9717,9967,8560,8329,8660,1057,139
13169,"Jones County, Georgia",28622,28292,23639,20739,16579,12043,139
13171,"Lamar County, Georgia",18834,17837,15912,13038,12215,6619,131
13173,"Lanier County, Georgia",10534,9404,7241,5531,5654,4880,139
13175,"Laurens County, Georgia",47404,48034,44874,39988,36990,10414,139
13177,"Lee County, Georgia",29735,27998,24757,16250,11684,18051,139
13179,"Liberty County, Georgia",62039,63854,61610,52745,37583,24456,132
13181,"Lincoln County, Georgia",7929,8111,8348,7442,6716,1213,139
13183,"Long County, Georgia",19236,13142,10304,6202,4524,14712,132
13185,"Lowndes County, Georgia",116436,104916,92115,75981,67972,48464,139
13187,"Lumpkin County, Georgia",33009,28875,21016,14573,10762,22247,139
13189,"Mcduffie County, Georgia",21404,21719,21231,20119,18546,2858,139
13191,"Mcintosh County, Georgia",14217,13817,10847,8634,8046,6171,139
13193,"Macon County, Georgia",13107,14553,14074,13114,14003,-896,139
13195,"Madison County, Georgia",29624,27798,25730,21050,17747,11877,139
13197,"Marion County, Georgia",8450,8403,7144,5590,5297,3153,139
13199,"Meriwether County, Georgia",21080,22425,22534,22411,21229,-149,131
13201,"Miller County, Georgia",5725,6128,6383,6280,7038,-1313,139
13205,"Mitchell County, Georgia",22072,23697,23932,20275,21114,958,139
13207,"Monroe County, Georgia",27455,25864,21757,17113,14610,12845,139
13209,"Montgomery County, Georgia",9069,9138,8270,7163,7011,2058,139
13211,"Morgan County, Georgia",18832,17741,15457,12883,11572,7260,139
13213,"Murray County, Georgia",39789,39925,36506,26147,19685,20104,139
13215,"Muscogee County, Georgia",195418,187629,186291,179278,170108,25310,139
13217,"Newton County, Georgia",109835,96833,62001,41808,34489,75346,131
13219,"Oconee County, Georgia",39194,31508,26225,17618,12427,26767,139
13221,"Oglethorpe County, Georgia",15040,14556,12635,9763,8929,6111,139
13223,"Paulding County, Georgia",164440,134875,81678,41611,26110,138330,131
13225,"Peach County, Georgia",27502,26883,23668,21189,19151,8351,139
13227,"Pickens County, Georgia",32002,29155,22983,14432,11652,20350,131
13229,"Pierce County, Georgia",19336,18205,15636,13328,11897,7439,139
13231,"Pike County, Georgia",18565,17411,13688,10224,8937,9628,131
13233,"Polk County, Georgia",42251,41095,38127,33815,32386,9865,131
13235,"Pulaski County, Georgia",11185,11632,9588,8108,8950,2235,139
13237,"Putnam County, Georgia",21906,20925,18812,14137,10295,11611,139
13239,"Quitman County, Georgia",2290,2528,2598,2209,2357,-67,139
13241,"Rabun County, Georgia",16859,16266,15050,11648,10466,6393,139
13243,"Randolph County, Georgia",6888,7724,7791,8023,9599,-2711,139
13245,"Richmond County, Georgia",202178,198170,199775,189719,181629,20549,139
13247,"Rockdale County, Georgia",90155,83135,70111,54091,36747,53408,131
13249,"Schley County, Georgia",5215,4755,3766,3588,3433,1782,139
13251,"Screven County, Georgia",13977,14799,15374,13842,14043,-66,139
13253,"Seminole County, Georgia",8218,8797,9369,9010,9057,-839,139
13255,"Spalding County, Georgia",66043,63304,58417,54457,47899,18144,131
13257,"Stephens County, Georgia",25934,25876,25435,23257,21763,4171,139
13259,"Stewart County, Georgia",6446,5831,5252,5654,5896,550,139
13261,"Sumter County, Georgia",29714,32865,33200,30228,29360,354,139
13263,"Talbot County, Georgia",6245,6920,6498,6524,6536,-291,139
13265,"Taliaferro County, Georgia",1596,2041,2077,1915,2032,-436,139
13267,"Tattnall County, Georgia",25392,24263,22305,17722,18134,7258,139
13269,"Taylor County, Georgia",8126,8875,8815,7642,7902,224,139
13271,"Telfair County, Georgia",15871,16052,11794,11000,11445,4426,139
13273,"Terrell County, Georgia",8654,9647,10970,10653,12017,-3363,139
13275,"Thomas County, Georgia",44545,44451,42737,38986,38098,6447,139
13277,"Tift County, Georgia",40590,39823,38407,34998,32862,7728,139
13279,"Toombs County, Georgia",26947,27151,26067,24072,22592,4355,139
13281,"Towns County, Georgia",11815,10430,9319,6754,5638,6177,139
13283,"Treutlen County, Georgia",6787,6835,6854,5994,6087,700,139
13285,"Troup County, Georgia",70095,65652,58779,55536,50003,20092,131
13287,"Turner County, Georgia",7920,9025,9504,8703,9510,-1590,139
13289,"Twiggs County, Georgia",8195,9385,10590,9806,9354,-1159,139
13291,"Union County, Georgia",23999,21083,17289,11993,9390,14609,139
13293,"Upson County, Georgia",26329,27308,27597,26300,25998,331,131
13295,"Walker County, Georgia",69398,67845,61053,58340,56470,12928,139
13297,"Walton County, Georgia",93284,81491,60687,38586,31211,62073,131
13299,"Ware County, Georgia",35745,36006,35483,35471,37180,-1435,139
13301,"Warren County, Georgia",5259,5936,6336,6078,6583,-1324,139
13303,"Washington County, Georgia",20316,21112,21176,19112,18842,1474,139
13305,"Wayne County, Georgia",29959,29705,26565,22356,20750,9209,139
13307,"Webster County, Georgia",2587,2727,2390,2263,2341,246,139
13309,"Wheeler County, Georgia",7897,7093,6179,4903,5155,2742,139
13311,"White County, Georgia",29962,26498,19944,13006,10120,19842,139
13313,"Whitfield County, Georgia",104122,99910,83525,72462,65789,38333,139
13315,"Wilcox County, Georgia",8701,9041,8577,7008,7682,1019,139
13317,"Wilkes County, Georgia",9797,10580,10687,10597,10951,-1154,139
13319,"Wilkinson County, Georgia",8945,9685,10220,10228,10368,-1423,139
13321,"Worth County, Georgia",20346,21712,21967,19745,18064,2282,139
16001,"Ada County, Idaho",469473,380718,300904,205775,173036,296437,160
16003,"Adams County, Idaho",4200,3942,3476,3254,3347,853,160
16005,"Bannock County, Idaho",86742,80701,75565,66026,65421,21321,160
16007,"Bear Lake County, Idaho",6054,6026,6411,6084,6931,-877,160
16009,"Benewah County, Idaho",9231,9302,9171,7937,8292,939,160
16011,"Bingham County, Idaho",46246,44496,41735,37583,36489,9757,160
16013,"Blaine County, Idaho",22729,21329,18991,13552,9841,12888,160
16015,"Boise County, Idaho",7625,7122,6670,3509,2999,4626,160
16017,"Bonner County, Idaho",44688,40711,36835,26622,24163,20525,160
16019,"Bonneville County, Idaho",116970,100213,82522,72207,65980,50990,160
16021,"Boundary County, Idaho",12156,10792,9871,8332,7289,4867,160
16023,"Butte County, Idaho",2603,2842,2899,2918,3342,-739,160
16025,"Camas County, Idaho",1069,1216,991,727,818,251,160
16027,"Canyon County, Idaho",223890,182723,131441,90076,83756,140134,160
16029,"Caribou County, Idaho",7028,6900,7304,6963,8695,-1667,160
16031,"Cassia County, Idaho",23847,22109,21416,19532,19427,4420,160
16033,"Clark County, Idaho",885,857,1022,762,798,87,160
16035,"Clearwater County, Idaho",8735,8766,8930,8505,10390,-1655,160
16037,"Custer County, Idaho",4193,4277,4342,4133,3385,808,160
16039,"Elmore County, Idaho",27043,26669,29130,21205,21565,5478,160
16041,"Franklin County, Idaho",13736,12497,11329,9232,8895,4841,160
16043,"Fremont County, Idaho",13111,13062,11819,10937,10813,2298,160
16045,"Gem County, Idaho",17771,16778,15181,11844,11972,5799,160
16047,"Gooding County, Idaho",15280,15140,14155,11633,11874,3406,160
16049,"Idaho County, Idaho",16511,15947,15511,13783,14769,1742,160
16051,"Jefferson County, Idaho",29238,24523,19155,16543,15304,13934,160
16053,"Jerome County, Idaho",24074,21282,18342,15138,14840,9234,160
16055,"Kootenai County, Idaho",161676,134851,108685,69795,59770,101906,160
16057,"Latah County, Idaho",40052,36645,34935,30617,28749,11303,160
16059,"Lemhi County, Idaho",7929,7861,7806,6899,7460,469,160
16061,"Lewis County, Idaho",3850,3761,3747,3516,4118,-268,160
16063,"Lincoln County, Idaho",5342,5021,4044,3308,3436,1906,160
16065,"Madison County, Idaho",39725,36413,27467,23674,19480,20245,160
16067,"Minidoka County, Idaho",20817,19524,20174,19361,19718,1099,160
16069,"Nez Perce County, Idaho",40468,38886,37410,33754,33220,7248,160
16071,"Oneida County, Idaho",4429,4212,4125,3492,3258,1171,160
16073,"Owyhee County, Idaho",11724,11389,10644,8392,8272,3452,160
16075,"Payette County, Idaho",23705,22451,20578,16434,15722,7983,160
16077,"Power County, Idaho",7635,7633,7538,7086,6844,791,160
16079,"Shoshone County, Idaho",12700,12917,13771,13931,19226,-6526,160
16081,"Teton County, Idaho",11776,9413,5999,3439,2897,8879,160
16083,"Twin Falls County, Idaho",86198,74929,64284,53580,52927,33271,160
16085,"Valley County, Idaho",11085,9846,7651,6109,5604,5481,160
16087,"Washington County, Idaho",10128,10105,9977,8550,8803,1325,160
17001,"Adams County, Illinois",65670,67030,68277,66090,71622,-5952,179
17003,"Alexander County, Illinois",6011,8449,9590,10626,12264,-6253,179
17005,"Bond County, Illinois",16520,17904,17633,14991,16224,296,172
17007,"Boone County, Illinois",53293,53567,41786,30806,28630,24663,179
17009,"Brown County, Illinois",6599,6897,6950,5836,5411,1188,179
17011,"Bureau County, Illinois",32878,35083,35503,35688,39114,-6236,179
17013,"Calhoun County, Illinois",4782,5118,5084,5322,5867,-1085,172
17015,"Carroll County, Illinois",14398,15615,16674,16805,18779,-4381,179
17017,"Cass County, Illinois",12324,13648,13695,13437,15084,-2760,179
17019,"Champaign County, Illinois",210006,197867,179669,173025,168392,41614,179
17021,"Christian County, Illinois",32705,34936,35372,34418,36446,-3741,179
17023,"Clark County, Illinois",15602,16545,17008,15921,16913,-1311,179
17025,"Clay County, Illinois",13217,13927,14560,14460,15283,-2066,179
17027,"Clinton County, Illinois",37549,37395,35535,33944,32617,4932,172
17029,"Coles County, Illinois",51065,53568,53196,51644,52260,-1195,179
17031,"Cook County, Illinois",5169517,5172848,5376741,5105067,5253655,-84138,171
17033,"Crawford County, Illinois",18833,19864,20452,19464,20818,-1985,179
17035,"Cumberland County, Illinois",10787,11073,11253,10670,11062,-275,179
17037,"De Kalb County, Illinois",104588,104026,88969,77932,74624,29964,171
17039,"De Witt County, Illinois",15764,16672,16798,16516,18108,-2344,179
17041,"Douglas County, Illinois",19551,20012,19922,19464,19774,-223,179
17043,"Du Page County, Illinois",926005,911481,904161,781666,658835,267170,171
17045,"Edgar County, Illinois",17272,18776,19704,19595,21725,-4453,179
17047,"Edwards County, Illinois",6431,6707,6971,7440,7961,-1530,179
17049,"Effingham County, Illinois",34151,34232,34264,31704,30944,3207,179
17051,"Fayette County, Illinois",21418,22007,21802,20893,22167,-749,179
17053,"Ford County, Illinois",13155,14113,14241,14275,15265,-2110,179
17055,"Franklin County, Illinois",38688,39528,39018,40319,43201,-4513,179
17057,"Fulton County, Illinois",34654,37205,38250,38080,43687,-9033,179
17059,"Gallatin County, Illinois",4983,5773,6445,6909,7590,-2607,179
17061,"Greene County, Illinois",12988,13983,14761,15317,16661,-3673,179
17063,"Grundy County, Illinois",50798,48744,37535,32337,30582,20216,171
17065,"Hamilton County, Illinois",8151,8453,8621,8499,9172,-1021,179
17067,"Hancock County, Illinois",17820,19227,20121,21373,23877,-6057,179
17069,"Hardin County, Illinois",3890,4402,4800,5189,5383,-1493,179
17071,"Henderson County, Illinois",6737,7462,8213,8096,9114,-2377,179
17073,"Henry County, Illinois",49032,50477,51020,51159,57968,-8936,179
17075,"Iroquois County, Illinois",27437,30068,31334,30787,32976,-5539,179
17077,"Jackson County, Illinois",57517,59864,59612,61067,61522,-4005,179
17079,"Jasper County, Illinois",9547,9752,10117,10609,11318,-1771,179
17081,"Jefferson County, Illinois",37774,39202,40045,37020,36552,1222,179
17083,"Jersey County, Illinois",21776,22932,21668,20539,20538,1238,172
17085,"Jo Daviess County, Illinois",21429,22728,22289,21821,23520,-2091,179
17087,"Johnson County, Illinois",12391,12710,12878,11347,9624,2767,179
17089,"Kane County, Illinois",531756,502628,404119,317471,278405,253351,171
17091,"Kankakee County, Illinois",109924,112100,103833,96255,102926,6998,171
17093,"Kendall County, Illinois",127583,105602,54544,39413,37202,90381,171
17095,"Knox County, Illinois",50052,52932,55836,56393,61607,-11555,179
17097,"Lake County, Illinois",699682,697179,644356,516418,440372,259310,171
17099,"La Salle County, Illinois",108998,113789,111509,106913,112033,-3035,179
17101,"Lawrence County, Illinois",15830,16849,15452,15972,17807,-1977,179
17103,"Lee County, Illinois",34204,36100,36062,34392,36328,-2124,179
17105,"Livingston County, Illinois",35757,39010,39678,39301,41381,-5624,179
17107,"Logan County, Illinois",28818,30440,31183,30798,31802,-2984,179
17109,"Mcdonough County, Illinois",30107,32730,32913,35244,37467,-7360,179
17111,"Mchenry County, Illinois",307291,306050,260077,183241,147897,159394,171
17113,"Mclean County, Illinois",172164,166706,150433,129180,119149,53015,179
17115,"Macon County, Illinois",104688,110719,114706,117206,131375,-26687,179
17117,"Macoupin County, Illinois",45243,47980,49019,47679,49384,-4141,172
17119,"Madison County, Illinois",264403,268005,258941,249238,247691,16712,172
17121,"Marion County, Illinois",37524,39722,41691,41561,43523,-5999,179
17123,"Marshall County, Illinois",11562,12763,13180,12846,14479,-2917,179
17125,"Mason County, Illinois",13486,14921,16038,16269,19492,-6006,179
17127,"Massac County, Illinois",14041,15425,15161,14752,14990,-949,179
17129,"Menard County, Illinois",12261,12702,12486,11164,11700,561,179
17131,"Mercer County, Illinois",15503,16551,16957,17290,19286,-3783,179
17133,"Monroe County, Illinois",34444,32431,27619,22422,20117,14327,172
17135,"Montgomery County, Illinois",28598,30230,30652,30728,31686,-3088,179
17137,"Morgan County, Illinois",34012,35755,36616,36397,37502,-3490,179
17139,"Moultrie County, Illinois",14557,14723,14287,13930,14546,11,179
17141,"Ogle County, Illinois",50793,53578,51032,45957,46338,4455,179
17143,"Peoria County, Illinois",181111,185108,183433,182827,200466,-19355,179
17145,"Perry County, Illinois",21092,22488,23094,21412,21714,-622,179
17147,"Piatt County, Illinois",16412,16708,16365,15548,16581,-169,179
17149,"Pike County, Illinois",15571,16580,17384,17577,18896,-3325,179
17151,"Pope County, Illinois",4177,4426,4413,4373,4404,-227,179
17153,"Pulaski County, Illinois",5414,6262,7348,7523,8840,-3426,179
17155,"Putnam County, Illinois",5720,5982,6086,5730,6085,-365,179
17157,"Randolph County, Illinois",31973,33567,33893,34583,35652,-3679,179
17159,"Richland County, Illinois",15677,16166,16149,16545,17587,-1910,179
17161,"Rock Island County, Illinois",142801,147524,149374,148723,165968,-23167,179
17163,"St. Clair County, Illinois",261186,266727,256082,262852,267531,-6345,172
17165,"Saline County, Illinois",23735,25171,26733,26551,28448,-4713,179
17167,"Sangamon County, Illinois",195963,195288,188951,178386,176089,19874,179
17169,"Schuyler County, Illinois",6897,7527,7189,7498,8365,-1468,179
17171,"Scott County, Illinois",4982,5374,5537,5644,6142,-1160,179
17173,"Shelby County, Illinois",21623,22362,22893,22261,23923,-2300,179
17175,"Stark County, Illinois",5393,6086,6332,6534,7389,-1996,179
17177,"Stephenson County, Illinois",44683,47791,48979,48052,49536,-4853,179
17179,"Tazewell County, Illinois",132524,133863,128485,123692,132078,446,179
17181,"Union County, Illinois",16829,17959,18293,17619,17765,-936,179
17183,"Vermilion County, Illinois",76704,82033,83919,88257,95222,-18518,179
17185,"Wabash County, Illinois",11390,12141,12937,13111,13713,-2323,179
17187,"Warren County, Illinois",16981,17745,18735,19181,21943,-4962,179
17189,"Washington County, Illinois",13967,14841,15148,14965,15472,-1505,179
17191,"Wayne County, Illinois",16309,16846,17151,17241,18059,-1750,179
17193,"White County, Illinois",13712,14800,15371,16522,17864,-4152,179
17195,"Whiteside County, Illinois",55583,58750,60653,60186,65970,-10387,179
17197,"Will County, Illinois",689704,667977,502266,357313,324460,365244,171
17199,"Williamson County, Illinois",66929,65579,61296,57733,56538,10391,179
17201,"Winnebago County, Illinois",283635,293972,278418,252913,250884,32751,179
17203,"Woodford County, Illinois",38503,38226,35469,32653,33320,5183,179
18001,"Adams County, Indiana",35544,34162,33625,31095,29619,5925,189
18003,"Allen County, Indiana",375520,351332,331849,300836,294335,81185,189
18005,"Bartholomew County, Indiana",83280,75855,71435,63657,65088,18192,182
18007,"Benton County, Indiana",8695,8820,9421,9441,10218,-1523,189
18009,"Blackford County, Indiana",11926,12960,14048,14067,15570,-3644,189
18011,"Boone County, Indiana",66875,54796,46107,38147,36446,30429,182
18013,"Brown County, Indiana",15093,15271,14957,14080,12377,2716,182
18015,"Carroll County, Indiana",20137,20135,20165,18809,19722,415,189
18017,"Cass County, Indiana",37727,39058,40930,38413,40936,-3209,189
18019,"Clark County, Indiana",117410,107381,96472,87777,88838,28572,189
18021,"Clay County, Indiana",26231,26983,26556,24705,24862,1369,189
18023,"Clinton County, Indiana",32186,33270,33866,30974,31545,641,189
18025,"Crawford County, Indiana",10582,10825,10743,9914,9820,762,189
18027,"Daviess County, Indiana",33277,31045,29820,27533,27836,5441,189
18029,"Dearborn County, Indiana",49612,49580,46109,38835,34291,15321,189
18031,"Decatur County, Indiana",26587,25584,24555,23645,23841,2746,189
18033,"De Kalb County, Indiana",43193,41968,40285,35324,33606,9587,189
18035,"Delaware County, Indiana",114461,117344,118769,119659,128587,-14126,189
18037,"Dubois County, Indiana",42534,41809,39674,36616,34238,8296,189
18039,"Elkhart County, Indiana",205184,196855,182791,156198,137330,67854,189
18041,"Fayette County, Indiana",23068,24367,25588,26015,28272,-5204,189
18043,"Floyd County, Indiana",77879,73594,70823,64404,61169,16710,189
18045,"Fountain County, Indiana",16456,17329,17954,17808,19033,-2577,189
18047,"Franklin County, Indiana",22750,23194,22151,19580,19612,3138,189
18049,"Fulton County, Indiana",20069,20684,20511,18840,19335,734,189
18051,"Gibson County, Indiana",33711,33386,32500,31913,33156,555,189
18053,"Grant County, Indiana",66055,70176,73403,74169,80934,-14879,189
18055,"Greene County, Indiana",32174,33084,33157,30410,30416,1758,189
18057,"Hamilton County, Indiana",330455,261244,182740,108936,82027,248428,182
18059,"Hancock County, Indiana",76614,68011,55391,45527,43939,32675,182
18061,"Harrison County, Indiana",40164,38616,34325,29890,27276,12888,189
18063,"Hendricks County, Indiana",166806,140028,104093,75717,69804,97002,182
18065,"Henry County, Indiana",48158,48921,48508,48139,53336,-5178,182
18067,"Howard County, Indiana",82486,83326,84964,80827,86896,-4410,189
18069,"Huntington County, Indiana",36351,37321,38075,35427,35596,755,189
18071,"Jackson County, Indiana",44077,41902,41335,37730,36523,7554,189
18073,"Jasper County, Indiana",33433,33055,30043,24960,26138,7295,181
18075,"Jay County, Indiana",20697,21441,21806,21512,23239,-2542,189
18077,"Jefferson County, Indiana",32167,32393,31705,29797,30419,1748,189
18079,"Jennings County, Indiana",27639,28470,27554,23661,22854,4785,182
18081,"Johnson County, Indiana",156148,135994,115209,88109,77240,78908,182
18083,"Knox County, Indiana",36833,38425,39256,39884,41838,-5005,189
18085,"Kosciusko County, Indiana",79156,76982,74057,65294,59555,19601,189
18087,"Lagrange County, Indiana",39537,36996,34909,29477,25550,13987,189
18089,"Lake County, Indiana",485983,494417,484564,475594,522965,-36982,181
18091,"La Porte County, Indiana",110026,110937,110106,107066,108632,1394,181
18093,"Lawrence County, Indiana",45552,46192,45922,42836,42472,3080,189
18095,"Madison County, Indiana",129486,131444,133358,130669,139336,-9850,182
18097,"Marion County, Indiana",957337,890976,860454,797159,765233,192104,182
18099,"Marshall County, Indiana",46336,46976,45128,42182,39155,7181,189
18101,"Martin County, Indiana",10169,10324,10369,10369,11001,-832,189
18103,"Miami County, Indiana",35684,37307,36082,36897,39820,-4136,189
18105,"Monroe County, Indiana",147318,134442,120563,108978,98785,48533,189
18107,"Montgomery County, Indiana",38295,38138,37629,34436,35501,2794,182
18109,"Morgan County, Indiana",70141,68654,66689,55920,51999,18142,182
18111,"Newton County, Indiana",13981,14300,14566,13551,14844,-863,181
18113,"Noble County, Indiana",47640,47513,46275,37877,35443,12197,189
18115,"Ohio County, Indiana",5890,6067,5623,5315,5114,776,189
18117,"Orange County, Indiana",19552,19820,19306,18409,18677,875,189
18119,"Owen County, Indiana",20854,21737,21786,17281,15841,5013,189
18121,"Parke County, Indiana",16912,17394,17241,15410,16372,540,189
18123,"Perry County, Indiana",19091,19316,18899,19107,19346,-255,189
18125,"Pike County, Indiana",12364,12955,12837,12509,13465,-1101,189
18127,"Porter County, Indiana",169482,162026,146798,128932,119816,49666,181
18129,"Posey County, Indiana",25480,26100,27061,25968,26414,-934,189
18131,"Pulaski County, Indiana",12482,13596,13755,12643,13258,-776,189
18133,"Putnam County, Indiana",37419,38048,36019,30315,29163,8256,182
18135,"Randolph County, Indiana",24694,26262,27401,27148,29997,-5303,189
18137,"Ripley County, Indiana",28457,28570,26523,24616,24398,4059,189
18139,"Rush County, Indiana",16632,17568,18261,18129,19604,-2972,189
18141,"St. Joseph County, Indiana",270881,266522,265559,247052,241617,29264,189
18143,"Scott County, Indiana",23785,24109,22960,20991,20422,3363,189
18145,"Shelby County, Indiana",44559,44237,43445,40307,39887,4672,182
18147,"Spencer County, Indiana",20364,20977,20391,19490,19361,1003,189
18149,"Starke County, Indiana",22996,23343,23556,22747,21997,999,189
18151,"Steuben County, Indiana",34591,34092,33214,27446,24694,9897,189
18153,"Sullivan County, Indiana",20647,21520,21751,18993,21107,-460,189
18155,"Switzerland County, Indiana",10727,10393,9065,7738,7153,3574,189
18157,"Tippecanoe County, Indiana",193302,168635,148955,130598,121702,71600,189
18159,"Tipton County, Indiana",15154,16132,16577,16119,16819,-1665,189
18161,"Union County, Indiana",7140,7463,7349,6976,6860,280,189
18163,"Vanderburgh County, Indiana",181548,178298,171922,165058,167515,14033,189
18165,"Vermillion County, Indiana",15485,16412,16788,16773,18229,-2744,189
18167,"Vigo County, Indiana",107305,107151,105848,106107,112385,-5080,189
18169,"Wabash County, Indiana",31198,33225,34960,35069,36640,-5442,189
18171,"Warren County, Indiana",8219,8563,8419,8176,8976,-757,189
18173,"Warrick County, Indiana",62608,58393,52383,44920,41474,21134,189
18175,"Washington County, Indiana",27942,28226,27223,23717,21932,6010,189
18177,"Wayne County, Indiana",66176,69187,71097,71951,76058,-9882,189
18179,"Wells County, Indiana",28010,27744,27600,25948,25401,2609,189
18181,"White County, Indiana",24163,24734,25267,23265,23867,296,189
18183,"Whitley County, Indiana",33899,32991,30707,27651,26215,7684,189
19001,"Adair County, Iowa",7048,7779,8243,8409,9509,-2461,190
19003,"Adams County, Iowa",3633,4127,4482,4866,5731,-2098,190
19005,"Allamakee County, Iowa",13761,14331,14675,13855,15108,-1347,190
19007,"Appanoose County, Iowa",12462,13029,13721,13743,15511,-3049,190
19009,"Audubon County, Iowa",5528,6186,6830,7334,8559,-3031,190
19011,"Benton County, Iowa",25558,26098,25308,22429,23649,1909,190
19013,"Black Hawk County, Iowa",131813,129252,128012,123798,137961,-6148,190
19015,"Boone County, Iowa",26381,26424,26224,25186,26184,197,190
19017,"Bremer County, Iowa",25032,24185,23325,22813,24820,212,190
19019,"Buchanan County, Iowa",21141,21026,21093,20844,22900,-1759,190
19021,"Buena Vista County, Iowa",19950,19980,20411,19965,20774,-824,190
19023,"Butler County, Iowa",14508,14892,15305,15731,17668,-3160,190
19025,"Calhoun County, Iowa",9656,9846,11115,11508,13542,-3886,190
19027,"Carroll County, Iowa",20150,20805,21421,21423,22951,-2801,190
19029,"Cass County, Iowa",12990,13969,14684,15128,16932,-3942,190
19031,"Cedar County, Iowa",18475,18414,18187,17381,18635,-160,190
19033,"Cerro Gordo County, Iowa",42672,44324,46447,46733,48458,-5786,190
19035,"Cherokee County, Iowa",11281,12086,13035,14098,16238,-4957,190
19037,"Chickasaw County, Iowa",11970,12499,13095,13295,15437,-3467,190
19039,"Clarke County, Iowa",9383,9218,9133,8287,8612,771,190
19041,"Clay County, Iowa",16138,16718,17372,17585,19576,-3438,190
19043,"Clayton County, Iowa",17527,18202,18678,19054,21098,-3571,190
19045,"Clinton County, Iowa",46734,49274,50149,51040,57122,-10388,190
19047,"Crawford County, Iowa",16998,16951,16942,16775,18935,-1937,190
19049,"Dallas County, Iowa",90418,61714,40750,29755,29513,60905,190
19051,"Davis County, Iowa",8977,8687,8541,8312,9104,-127,190
19053,"Decatur County, Iowa",7908,8508,8689,8338,9794,-1886,190
19055,"Delaware County, Iowa",17107,17857,18404,18035,18933,-1826,190
19057,"Des Moines County, Iowa",39227,40266,42351,42614,46203,-6976,190
19059,"Dickinson County, Iowa",17260,16665,16424,14909,15629,1631,190
19061,"Dubuque County, Iowa",97193,92547,89143,86403,93745,3448,190
19063,"Emmet County, Iowa",9322,10389,11027,11569,13336,-4014,190
19065,"Fayette County, Iowa",19604,20992,22008,21843,25488,-5884,190
19067,"Floyd County, Iowa",15713,16394,16900,17058,19597,-3884,190
19069,"Franklin County, Iowa",10091,10697,10704,11364,13036,-2945,190
19071,"Fremont County, Iowa",6895,7528,8010,8226,9401,-2506,190
19073,"Greene County, Iowa",8923,9448,10366,10045,12119,-3196,190
19075,"Grundy County, Iowa",12262,12401,12369,12029,14366,-2104,190
19077,"Guthrie County, Iowa",10702,11040,11353,10935,11983,-1281,190
19079,"Hamilton County, Iowa",14905,15874,16438,16071,17862,-2957,190
19081,"Hancock County, Iowa",10709,11505,12100,12638,13833,-3124,190
19083,"Hardin County, Iowa",16924,17685,18812,19094,21776,-4852,190
19085,"Harrison County, Iowa",14043,15073,15666,14730,16348,-2305,190
19087,"Henry County, Iowa",19889,20263,20336,19226,18890,999,190
19089,"Howard County, Iowa",9201,9610,9932,9809,11114,-1913,190
19091,"Humboldt County, Iowa",9518,9905,10381,10756,12246,-2728,190
19093,"Ida County, Iowa",6862,7172,7837,8365,8908,-2046,190
19095,"Iowa County, Iowa",16155,16353,15671,14630,15429,726,190
19097,"Jackson County, Iowa",19348,19942,20296,19950,22503,-3155,190
19099,"Jasper County, Iowa",37032,37050,37213,34795,36425,607,190
19101,"Jefferson County, Iowa",18153,16643,16181,16310,16316,1837,190
19103,"Johnson County, Iowa",150819,126994,111006,96119,81717,69102,190
19105,"Jones County, Iowa",20575,20708,20221,19444,20401,174,190
19107,"Keokuk County, Iowa",10163,10614,11400,11624,12921,-2758,190
19109,"Kossuth County, Iowa",14864,15748,17163,18591,21891,-7027,190
19111,"Lee County, Iowa",33946,35991,38052,38687,43106,-9160,190
19113,"Linn County, Iowa",225601,207765,191701,168767,169775,55826,190
19115,"Louisa County, Iowa",11125,11683,12183,11592,12055,-930,190
19117,"Lucas County, Iowa",8556,9116,9422,9070,10313,-1757,190
19119,"Lyon County, Iowa",11800,11564,11763,11952,12896,-1096,190
19121,"Madison County, Iowa",16148,15488,14019,12483,12597,3551,190
19123,"Mahaska County, Iowa",22351,22382,22335,21522,22867,-516,190
19125,"Marion County, Iowa",33193,33378,32052,30001,29669,3524,190
19127,"Marshall County, Iowa",39804,40131,39311,38276,41652,-1848,190
19129,"Mills County, Iowa",15023,15157,14547,13202,13406,1617,190
19131,"Mitchell County, Iowa",10588,10801,10874,10928,12329,-1741,190
19133,"Monona County, Iowa",8675,9346,10020,10034,11692,-3017,190
19135,"Monroe County, Iowa",7761,7918,8016,8114,9209,-1448,190
19137,"Montgomery County, Iowa",10016,10901,11771,12076,13413,-3397,190
19139,"Muscatine County, Iowa",42703,42501,41722,39907,40436,2267,190
19141,"O'brien County, Iowa",13796,14419,15102,15444,16972,-3176,190
19143,"Osceola County, Iowa",6016,6576,7003,7267,8371,-2355,190
19145,"Page County, Iowa",15205,16095,16976,16870,19063,-3858,190
19147,"Palo Alto County, Iowa",8941,9508,10147,10669,12721,-3780,190
19149,"Plymouth County, Iowa",25141,24933,24849,23388,24743,398,190
19151,"Pocahontas County, Iowa",6725,7509,8662,9525,11369,-4644,190
19153,"Polk County, Iowa",485418,419301,374601,327140,303170,182248,190
19155,"Pottawattamie County, Iowa",93478,91928,87704,82628,86561,6917,190
19157,"Poweshiek County, Iowa",18391,19012,18815,19033,19306,-915,190
19159,"Ringgold County, Iowa",4922,5169,5469,5420,6112,-1190,190
19161,"Sac County, Iowa",9711,10480,11529,12324,14118,-4407,190
19163,"Scott County, Iowa",172938,162184,158668,150979,160022,12916,190
19165,"Shelby County, Iowa",11544,12328,13173,13230,15043,-3499,190
19167,"Sioux County, Iowa",34900,33377,31589,29903,30813,4087,190
19169,"Story County, Iowa",97355,87594,79981,74252,72326,25029,190
19171,"Tama County, Iowa",16962,17952,18103,17419,19533,-2571,190
19173,"Taylor County, Iowa",6160,6402,6958,7114,8353,-2193,190
19175,"Union County, Iowa",12303,12409,12309,12750,13858,-1555,190
19177,"Van Buren County, Iowa",7104,7645,7809,7676,8626,-1522,190
19179,"Wapello County, Iowa",35102,35553,36051,35687,40241,-5139,190
19181,"Warren County, Iowa",50867,45346,40671,36033,34878,15989,190
19183,"Washington County, Iowa",22100,21626,20670,19612,20141,1959,190
19185,"Wayne County, Iowa",6426,6404,6730,7067,8199,-1773,190
19187,"Webster County, Iowa",36348,38286,40235,40342,45953,-9605,190
19189,"Winnebago County, Iowa",10474,10962,11723,12122,13010,-2536,190
19191,"Winneshiek County, Iowa",20090,21031,21310,20847,21876,-1786,190
19193,"Woodbury County, Iowa",102687,101217,103877,98276,100884,1803,190
19195,"Worth County, Iowa",7422,7628,7909,7991,9075,-1653,190
19197,"Wright County, Iowa",12644,13384,14334,14269,16319,-3675,190
20001,"Allen County, Kansas",12503,13473,14385,14638,15654,-3151,209
20003,"Anderson County, Kansas",7877,8084,8110,7803,8749,-872,209
20005,"Atchison County, Kansas",16210,16889,16774,16932,18397,-2187,201
20007,"Barber County, Kansas",4493,4900,5307,5874,6548,-2055,209
20009,"Barton County, Kansas",26209,27499,28205,29382,31343,-5134,209
20011,"Bourbon County, Kansas",14539,15097,15379,14966,15969,-1430,209
20013,"Brown County, Kansas",9575,10019,10724,11128,11955,-2380,209
20015,"Butler County, Kansas",66890,64853,59482,50580,44782,22108,209
20017,"Chase County, Kansas",2604,2834,3030,3021,3309,-705,209
20019,"Chautauqua County, Kansas",3280,3736,4359,4407,5016,-1736,209
20021,"Cherokee County, Kansas",20017,21740,22605,21374,22304,-2287,209
20023,"Cheyenne County, Kansas",2639,2783,3165,3243,3678,-1039,209
20025,"Clark County, Kansas",2006,2231,2390,2418,2599,-593,209
20027,"Clay County, Kansas",8030,8531,8822,9158,9802,-1772,209
20029,"Cloud County, Kansas",8831,9538,10268,11023,12494,-3663,209
20031,"Coffey County, Kansas",8218,8587,8865,8404,9370,-1152,209
20033,"Comanche County, Kansas",1759,1865,1967,2313,2554,-795,209
20035,"Cowley County, Kansas",35090,36140,36291,36915,36824,-1734,209
20037,"Crawford County, Kansas",38874,38985,38242,35568,37916,958,209
20039,"Decatur County, Kansas",2826,3015,3472,4021,4509,-1683,209
20041,"Dickinson County, Kansas",18614,19643,19344,18958,20175,-1561,209
20043,"Doniphan County, Kansas",7616,7957,8249,8134,9268,-1652,209
20045,"Douglas County, Kansas",121304,109052,99962,81798,67640,53664,209
20047,"Edwards County, Kansas",2822,3052,3449,3787,4271,-1449,209
20049,"Elk County, Kansas",2502,2930,3261,3327,3918,-1416,209
20051,"Ellis County, Kansas",28747,28039,27507,26004,26098,2649,209
20053,"Ellsworth County, Kansas",6176,6476,6525,6586,6640,-464,209
20055,"Finney County, Kansas",36451,36139,40523,33070,23825,12626,209
20057,"Ford County, Kansas",33718,32727,32458,27463,24315,9403,209
20059,"Franklin County, Kansas",25643,25841,24784,21994,22062,3581,201
20061,"Geary County, Kansas",33309,30537,27947,30453,29852,3457,209
20063,"Gove County, Kansas",2650,2721,3068,3231,3726,-1076,209
20065,"Graham County, Kansas",2464,2663,2946,3543,3995,-1531,209
20067,"Grant County, Kansas",7324,7744,7909,7159,6977,347,209
20069,"Gray County, Kansas",6020,5870,5904,5396,5138,882,209
20071,"Greeley County, Kansas",1156,1294,1534,1774,1845,-689,209
20073,"Greenwood County, Kansas",6010,6824,7673,7847,8764,-2754,209
20075,"Hamilton County, Kansas",2552,2643,2670,2388,2514,38,209
20077,"Harper County, Kansas",5506,6033,6536,7124,7778,-2272,209
20079,"Harvey County, Kansas",34434,34150,32869,31028,30531,3903,209
20081,"Haskell County, Kansas",3990,4196,4307,3886,3814,176,209
20083,"Hodgeman County, Kansas",1872,1955,2085,2177,2269,-397,209
20085,"Jackson County, Kansas",13249,13360,12657,11525,11644,1605,209
20087,"Jefferson County, Kansas",18974,19059,18426,15905,15207,3767,209
20089,"Jewell County, Kansas",2854,3151,3791,4251,5241,-2387,209
20091,"Johnson County, Kansas",597574,531228,451086,355054,270269,327305,201
20093,"Kearny County, Kansas",3863,3966,4531,4027,3435,428,209
20095,"Kingman County, Kansas",7173,7949,8673,8292,8960,-1787,209
20097,"Kiowa County, Kansas",2483,2671,3278,3660,4046,-1563,209
20099,"Labette County, Kansas",19938,21791,22835,23693,25682,-5744,209
20101,"Lane County, Kansas",1523,1725,2155,2375,2472,-949,209
20103,"Leavenworth County, Kansas",81499,74611,68691,64371,54809,26690,201
20105,"Lincoln County, Kansas",3013,3308,3578,3653,4145,-1132,209
20107,"Linn County, Kansas",9687,9782,9570,8254,8234,1453,201
20109,"Logan County, Kansas",2789,2774,3046,3081,3478,-689,209
20111,"Lyon County, Kansas",33237,34974,35935,34732,35108,-1871,209
20113,"Mcpherson County, Kansas",28557,29178,29554,27268,26855,1702,209
20115,"Marion County, Kansas",11865,12689,13361,12888,13522,-1657,209
20117,"Marshall County, Kansas",9713,10147,10965,11705,12787,-3074,209
20119,"Meade County, Kansas",4120,4523,4631,4247,4788,-668,209
20121,"Miami County, Kansas",33740,32116,28351,23466,21618,12122,201
20123,"Mitchell County, Kansas",6053,6383,6932,7203,8117,-2064,209
20125,"Montgomery County, Kansas",32114,35453,36252,38816,42281,-10167,209
20127,"Morris County, Kansas",5551,5946,6104,6198,6419,-868,209
20129,"Morton County, Kansas",2656,3244,3496,3480,3454,-798,209
20131,"Nemaha County, Kansas",10109,10253,10717,10446,11211,-1102,209
20133,"Neosho County, Kansas",16008,16538,16997,17035,18967,-2959,209
20135,"Ness County, Kansas",2838,3120,3454,4033,4498,-1660,209
20137,"Norton County, Kansas",5416,5692,5953,5947,6689,-1273,209
20139,"Osage County, Kansas",15855,16426,16712,15248,15319,536,209
20141,"Osborne County, Kansas",3494,3906,4452,4867,5959,-2465,209
20143,"Ottawa County, Kansas",5776,6107,6163,5634,5971,-195,209
20145,"Pawnee County, Kansas",6539,6913,7233,7555,8065,-1526,209
20147,"Phillips County, Kansas",5297,5601,6001,6590,7406,-2109,209
20149,"Pottawatomie County, Kansas",24203,20781,18209,16128,14782,9421,209
20151,"Pratt County, Kansas",9324,9670,9647,9702,10275,-951,209
20153,"Rawlins County, Kansas",2490,2594,2966,3404,4105,-1615,209
20155,"Reno County, Kansas",62421,64054,64790,62389,64983,-2562,209
20157,"Republic County, Kansas",4607,5069,5835,6482,7569,-2962,209
20159,"Rice County, Kansas",9532,10128,10761,10610,11900,-2368,209
20161,"Riley County, Kansas",74059,69035,62843,67139,63505,10554,209
20163,"Rooks County, Kansas",4985,5241,5685,6039,7006,-2021,209
20165,"Rush County, Kansas",2953,3290,3551,3842,4516,-1563,209
20167,"Russell County, Kansas",6896,6915,7370,7835,8868,-1972,209
20169,"Saline County, Kansas",54384,54982,53597,49301,48905,5479,209
20171,"Scott County, Kansas",4893,4832,5120,5289,5782,-889,209
20173,"Sedgwick County, Kansas",515416,486123,452869,403662,366531,148885,209
20175,"Seward County, Kansas",21902,22588,22510,18743,17071,4831,209
20177,"Shawnee County, Kansas",177293,175537,169871,160976,154916,22377,209
20179,"Sheridan County, Kansas",2515,2578,2813,3043,3544,-1029,209
20181,"Sherman County, Kansas",5904,6002,6760,6926,7759,-1855,209
20183,"Smith County, Kansas",3594,3934,4536,5078,5947,-2353,209
20185,"Stafford County, Kansas",4125,4433,4789,5365,5694,-1569,209
20187,"Stanton County, Kansas",2030,2197,2406,2333,2339,-309,209
20189,"Stevens County, Kansas",5498,5533,5463,5048,4736,762,209
20191,"Sumner County, Kansas",22928,24257,25946,25841,24928,-2000,209
20193,"Thomas County, Kansas",7748,7757,8180,8258,8451,-703,209
20195,"Trego County, Kansas",2802,2979,3319,3694,4165,-1363,209
20197,"Wabaunsee County, Kansas",6877,7004,6885,6603,6867,10,209
20199,"Wallace County, Kansas",1583,1440,1749,1821,2045,-462,209
20201,"Washington County, Kansas",5474,5851,6483,7073,8543,-3069,209
20203,"Wichita County, Kansas",2112,2244,2531,2758,3041,-929,209
20205,"Wilson County, Kansas",8600,9598,10332,10289,12128,-3528,209
20207,"Woodson County, Kansas",3117,3352,3788,4116,4600,-1483,209
20209,"Wyandotte County, Kansas",165447,155462,157882,161993,172335,-6888,201
21001,"Adair County, Kentucky",19366,18542,17244,15360,15233,4133,219
21003,"Allen County, Kentucky",21065,19688,17800,14628,14128,6937,219
21005,"Anderson County, Kentucky",22580,21080,19111,14571,12567,10013,219
21007,"Ballard County, Kentucky",7914,8225,8286,7902,8798,-884,219
21009,"Barren County, Kentucky",44026,41685,38033,34001,34009,10017,219
21011,"Bath County, Kentucky",12421,11565,11085,9692,10025,2396,219
21013,"Bell County, Kentucky",26426,28793,30060,31506,34330,-7904,219
21015,"Boone County, Kentucky",132368,114723,85991,57589,45842,86526,219
21017,"Bourbon County, Kentucky",19998,19947,19360,19236,19405,593,219
21019,"Boyd County, Kentucky",47361,49330,49752,51150,55513,-8152,219
21021,"Boyle County, Kentucky",30090,28245,27697,25641,25066,5024,219
21023,"Bracken County, Kentucky",8308,8479,8279,7766,7738,570,219
21025,"Breathitt County, Kentucky",12802,14202,16100,15703,17004,-4202,219
21027,"Breckinridge County, Kentucky",20283,19893,18648,16312,16861,3422,219
21029,"Bullitt County, Kentucky",80921,72515,61236,47567,43346,37575,211
21031,"Butler County, Kentucky",12756,12763,13010,11245,11064,1692,219
21033,"Caldwell County, Kentucky",12679,12934,13060,13232,13473,-794,219
21035,"Calloway County, Kentucky",38991,36763,34177,30735,30031,8960,219
21037,"Campbell County, Kentucky",93608,89016,88616,83866,83317,10291,219
21039,"Carlisle County, Kentucky",4738,5126,5351,5238,5487,-749,219
21041,"Carroll County, Kentucky",10691,10703,10155,9292,9270,1421,219
21043,"Carter County, Kentucky",26976,27821,26889,24340,25060,1916,219
21045,"Casey County, Kentucky",15968,15939,15447,14211,14818,1150,219
21047,"Christian County, Kentucky",71470,72678,72265,68941,66878,4592,219
21049,"Clark County, Kentucky",36152,35305,33144,29496,28322,7830,219
21051,"Clay County, Kentucky",20110,22197,24556,21746,22752,-2642,219
21053,"Clinton County, Kentucky",10175,10161,9634,9135,9321,854,219
21055,"Crittenden County, Kentucky",8940,9313,9384,9196,9207,-267,219
21057,"Cumberland County, Kentucky",6660,6931,7147,6784,7289,-629,219
21059,"Daviess County, Kentucky",101001,95398,91545,87189,85949,15052,219
21061,"Edmonson County, Kentucky",12195,12086,11644,10357,9962,2233,219
21063,"Elliott County, Kentucky",7461,7493,6748,6455,6908,553,219
21065,"Estill County, Kentucky",14187,14733,15307,14614,14495,-308,219
21067,"Fayette County, Kentucky",322200,288045,260512,225366,204165,118035,219
21069,"Fleming County, Kentucky",14519,14318,13792,12292,12323,2196,219
21071,"Floyd County, Kentucky",35931,39949,42441,43586,48764,-12833,219
21073,"Franklin County, Kentucky",50744,49067,47687,43781,41830,8914,219
21075,"Fulton County, Kentucky",6064,6858,7752,8271,8971,-2907,219
21077,"Gallatin County, Kentucky",8760,8428,7870,5393,4842,3918,219
21079,"Garrard County, Kentucky",17554,16842,14792,11579,10853,6701,219
21081,"Grant County, Kentucky",25107,24604,22384,15737,13308,11799,219
21083,"Graves County, Kentucky",37125,36958,37028,33550,34049,3076,219
21085,"Grayson County, Kentucky",26313,25540,24053,21050,20854,5459,219
21087,"Green County, Kentucky",11000,11377,11518,10371,11043,-43,219
21089,"Greenup County, Kentucky",35359,36962,36891,36742,39132,-3773,219
21091,"Hancock County, Kentucky",8748,8555,8392,7864,7742,1006,219
21093,"Hardin County, Kentucky",109627,100876,94174,89240,88917,20710,211
21095,"Harlan County, Kentucky",26307,29688,33202,36574,41889,-15582,219
21097,"Harrison County, Kentucky",18763,18761,17983,16248,15166,3597,219
21099,"Hart County, Kentucky",18833,18201,17445,14890,15402,3431,219
21101,"Henderson County, Kentucky",45550,45943,44829,43044,40849,4701,219
21103,"Henry County, Kentucky",15999,15474,15060,12823,12740,3259,211
21105,"Hickman County, Kentucky",4461,4949,5262,5566,6065,-1604,219
21107,"Hopkins County, Kentucky",45044,46886,46519,46126,46174,-1130,219
21109,"Jackson County, Kentucky",13368,13560,13495,11955,11996,1372,219
21111,"Jefferson County, Kentucky",768419,729452,693604,664937,685004,83415,211
21113,"Jessamine County, Kentucky",53476,47073,39041,30508,26146,27330,219
21115,"Johnson County, Kentucky",22427,23325,23445,23248,24432,-2005,219
21117,"Kenton County, Kentucky",166552,158034,151464,142031,137058,29494,219
21119,"Knott County, Kentucky",15041,16587,17649,17906,17940,-2899,219
21121,"Knox County, Kentucky",31288,31765,31795,29676,30239,1049,219
21123,"Larue County, Kentucky",14269,14080,13373,11679,11922,2347,211
21125,"Laurel County, Kentucky",60631,58155,52715,43438,38982,21649,219
21127,"Lawrence County, Kentucky",15604,15841,15569,13998,14121,1483,219
21129,"Lee County, Kentucky",7088,7865,7916,7422,7754,-666,219
21131,"Leslie County, Kentucky",10081,11470,12401,13642,14882,-4801,219
21133,"Letcher County, Kentucky",21936,24462,25277,27000,30687,-8751,219
21135,"Lewis County, Kentucky",13345,13968,14092,13029,14545,-1200,219
21137,"Lincoln County, Kentucky",24493,24779,23361,20045,19053,5440,219
21139,"Livingston County, Kentucky",9172,9514,9804,9062,9219,-47,219
21141,"Logan County, Kentucky",27049,26838,26573,24416,24138,2911,219
21143,"Lyon County, Kentucky",8226,8367,8080,6624,6490,1736,219
21145,"Mccracken County, Kentucky",65485,65217,65514,62879,61310,4175,219
21147,"Mccreary County, Kentucky",17333,18122,17080,15603,15634,1699,219
21149,"Mclean County, Kentucky",9202,9635,9938,9628,10090,-888,219
21151,"Madison County, Kentucky",92090,81580,70872,57508,53352,38738,219
21153,"Magoffin County, Kentucky",12346,13294,13332,13077,13515,-1169,219
21155,"Marion County, Kentucky",19257,19619,18212,16499,17910,1347,219
21157,"Marshall County, Kentucky",31225,31386,30125,27205,25637,5588,219
21159,"Martin County, Kentucky",11421,13138,12578,12526,13925,-2504,219
21161,"Mason County, Kentucky",17122,17362,16800,16666,17765,-643,219
21163,"Meade County, Kentucky",28379,28907,26349,24170,22854,5525,211
21165,"Menifee County, Kentucky",6463,6427,6556,5092,5117,1346,219
21167,"Mercer County, Kentucky",21690,21272,20817,19148,19011,2679,219
21169,"Metcalfe County, Kentucky",10062,10130,10037,8963,9484,578,219
21171,"Monroe County, Kentucky",10616,11089,11756,11401,12353,-1737,219
21173,"Montgomery County, Kentucky",28042,25908,22554,19561,20046,7996,219
21175,"Morgan County, Kentucky",13270,14055,13948,11648,12103,1167,219
21177,"Muhlenberg County, Kentucky",30815,31541,31839,31318,32238,-1423,219
21179,"Nelson County, Kentucky",45915,42523,37477,29710,27584,18331,211
21181,"Nicholas County, Kentucky",7189,7136,6813,6725,7157,32,219
21183,"Ohio County, Kentucky",24081,23837,22916,21105,21765,2316,219
21185,"Oldham County, Kentucky",66508,58784,46178,33263,27795,38713,211
21187,"Owen County, Kentucky",10847,10928,10547,9035,8924,1923,219
21189,"Owsley County, Kentucky",4416,4742,4858,5036,5709,-1293,219
21191,"Pendleton County, Kentucky",14587,14894,14390,12036,10989,3598,219
21193,"Perry County, Kentucky",26266,28739,29390,30283,33763,-7497,219
21195,"Pike County, Kentucky",58595,65309,68736,72583,81123,-22528,219
21197,"Powell County, Kentucky",12283,12786,13237,11686,11101,1182,219
21199,"Pulaski County, Kentucky",64789,62062,56217,49489,45803,18986,219
21201,"Robertson County, Kentucky",2139,2278,2266,2124,2265,-126,219
21203,"Rockcastle County, Kentucky",16795,17075,16582,14803,13973,2822,219
21205,"Rowan County, Kentucky",24534,23075,22094,20353,19049,5485,219
21207,"Russell County, Kentucky",17846,17445,16315,14716,13708,4138,219
21209,"Scott County, Kentucky",55961,44868,33061,23867,21813,34148,219
21211,"Shelby County, Kentucky",48100,40899,33337,24824,23328,24772,211
21213,"Simpson County, Kentucky",18319,17214,16405,15145,14673,3646,219
21215,"Spencer County, Kentucky",18945,16582,11766,6801,5929,13016,211
21217,"Taylor County, Kentucky",25572,24247,22927,21146,21178,4394,219
21219,"Todd County, Kentucky",12334,12307,11971,10940,11874,460,219
21221,"Trigg County, Kentucky",14569,14117,12597,10361,9384,5185,219
21223,"Trimble County, Kentucky",8528,8872,8125,6090,6253,2275,211
21225,"Union County, Kentucky",14582,15077,15637,16557,17821,-3239,219
21227,"Warren County, Kentucky",130836,109775,92522,76673,71828,59008,219
21229,"Washington County, Kentucky",12044,11593,10916,10441,10764,1280,219
21231,"Wayne County, Kentucky",20447,20716,19923,17468,17022,3425,219
21233,"Webster County, Kentucky",13021,13734,14120,13955,14832,-1811,219
21235,"Whitley County, Kentucky",36252,36006,35865,33326,33396,2856,219
21237,"Wolfe County, Kentucky",7188,7315,7065,6503,6698,490,219
21239,"Woodford County, Kentucky",26486,24523,23208,19955,17778,8708,219
22001,"Acadia Parish, Louisiana",62371,61139,58861,55882,56427,5944,229
22003,"Allen Parish, Louisiana",25572,25816,25440,21226,21390,4182,229
22005,"Ascension Parish, Louisiana",125061,102501,76627,58214,50068,74993,221
22007,"Assumption Parish, Louisiana",22236,23487,23388,22753,22084,152,221
22009,"Avoyelles Parish, Louisiana",40465,42013,41481,39159,41393,-928,229
22011,"Beauregard Parish, Louisiana",37387,35000,32986,30083,29692,7695,229
22013,"Bienville Parish, Louisiana",13391,14546,15752,15979,16387,-2996,229
22015,"Bossier Parish, Louisiana",126952,113837,98310,86088,80721,46231,229
22017,"Caddo Parish, Louisiana",243243,253048,252161,248253,252358,-9115,229
22019,"Calcasieu Parish, Louisiana",202858,189134,183577,168134,167223,35635,222
22021,"Caldwell Parish, Louisiana",9959,10188,10560,9810,10761,-802,229
22023,"Cameron Parish, Louisiana",6963,7280,9991,9260,9336,-2373,222
22025,"Catahoula Parish, Louisiana",9586,10465,10920,11065,12287,-2701,229
22027,"Claiborne Parish, Louisiana",15854,17160,16851,17405,17095,-1241,229
22029,"Concordia Parish, Louisiana",19533,20502,20247,20828,22981,-3448,229
22031,"De Soto Parish, Louisiana",27395,26465,25494,25346,25727,1668,229
22033,"East Baton Rouge Parish, Louisiana",443158,435815,412852,380105,366191,76967,221
22035,"East Carroll Parish, Louisiana",6947,7964,9421,9709,11772,-4825,229
22037,"East Feliciana Parish, Louisiana",19228,20417,21360,19211,19015,213,221
22039,"Evangeline Parish, Louisiana",33491,34419,35434,33274,33343,148,229
22041,"Franklin Parish, Louisiana",20109,20727,21263,22387,24141,-4032,229
22043,"Grant Parish, Louisiana",22339,21675,18698,17526,16703,5636,229
22045,"Iberia Parish, Louisiana",70763,73395,73266,68297,63752,7011,229
22047,"Iberville Parish, Louisiana",32626,33513,33320,31049,32159,467,221
22049,"Jackson Parish, Louisiana",15822,16078,15397,15705,17321,-1499,229
22051,"Jefferson Parish, Louisiana",434903,431019,455466,448306,454592,-19689,223
22053,"Jefferson Davis Parish, Louisiana",31425,31500,31435,30722,32168,-743,222
22055,"Lafayette Parish, Louisiana",243692,215581,190503,164762,150017,93675,229
22057,"Lafourche Parish, Louisiana",97980,95428,89974,85860,82483,15497,229
22059,"La Salle Parish, Louisiana",14950,14680,14282,13662,17004,-2054,229
22061,"Lincoln Parish, Louisiana",47118,45797,42509,41745,39763,7355,229
22063,"Livingston Parish, Louisiana",140524,122798,91814,70526,58806,81718,221
22065,"Madison Parish, Louisiana",11137,12286,13728,12463,15975,-4838,229
22067,"Morehouse Parish, Louisiana",25189,28388,31021,31938,34803,-9614,229
22069,"Natchitoches Parish, Louisiana",38505,39274,39080,36689,39863,-1358,229
22071,"Orleans Parish, Louisiana",391249,295285,484674,496938,557515,-166266,223
22073,"Ouachita Parish, Louisiana",154679,152207,147250,142191,139241,15438,229
22075,"Plaquemines Parish, Louisiana",23305,22710,26757,25575,26049,-2744,223
22077,"Pointe Coupee Parish, Louisiana",21883,22837,22763,22540,24045,-2162,221
22079,"Rapides Parish, Louisiana",130376,130800,126337,131556,135282,-4906,229
22081,"Red River Parish, Louisiana",8462,9181,9622,9387,10433,-1971,229
22083,"Richland Parish, Louisiana",20251,20692,20981,20629,22187,-1936,229
22085,"Sabine Parish, Louisiana",23915,24119,23459,22646,25280,-1365,229
22087,"St. Bernard Parish, Louisiana",46694,27739,67229,66631,64097,-17403,223
22089,"St. Charles Parish, Louisiana",52856,52645,48072,42437,37259,15597,223
22091,"St. Helena Parish, Louisiana",10227,11125,10525,9874,9827,400,221
22093,"St. James Parish, Louisiana",21142,22096,21216,20879,21495,-353,229
22095,"St. John The Baptist Parish, Louisiana",43055,46728,43044,39996,31924,11131,223
22097,"St. Landry Parish, Louisiana",82786,84309,87700,80331,84128,-1342,229
22099,"St. Martin Parish, Louisiana",53607,51721,48583,43978,40214,13393,229
22101,"St. Mary Parish, Louisiana",50020,54348,53500,58086,64253,-14233,229
22103,"St. Tammany Parish, Louisiana",258447,228894,191268,144508,110869,147578,223
22105,"Tangipahoa Parish, Louisiana",133753,118190,100588,85709,80698,53055,229
22107,"Tensas Parish, Louisiana",4435,5430,6618,7103,8525,-4090,229
22109,"Terrebonne Parish, Louisiana",111297,111131,104503,96982,94393,16904,229
22111,"Union Parish, Louisiana",22270,22750,22803,20690,21167,1103,229
22113,"Vermilion Parish, Louisiana",59787,57280,53807,50055,48458,11329,229
22115,"Vernon Parish, Louisiana",49315,50451,52531,61961,53475,-4160,229
22117,"Washington Parish, Louisiana",46325,46578,43926,43185,44207,2118,223
22119,"Webster Parish, Louisiana",38813,41238,41831,41989,43631,-4818,229
22121,"West Baton Rouge Parish, Louisiana",26395,23274,21601,19419,19086,7309,221
22123,"West Carroll Parish, Louisiana",10934,11689,12314,12093,12922,-1988,229
22125,"West Feliciana Parish, Louisiana",15441,15681,15111,12915,12186,3255,221
22127,"Winn Parish, Louisiana",14165,15477,16894,16269,17253,-3088,229
23001,"Androscoggin County, Maine",107958,107882,103793,105259,99657,8301,230
23003,"Aroostook County, Maine",67431,72412,73938,86936,91331,-23900,230
23005,"Cumberland County, Maine",294520,279994,265612,243135,215789,78731,230
23007,"Franklin County, Maine",29933,30657,29467,29008,27098,2835,230
23009,"Hancock County, Maine",54832,54309,51791,46948,41781,13051,230
23011,"Kennebec County, Maine",122158,121925,117114,115904,109889,12269,230
23013,"Knox County, Maine",39809,40111,39618,36310,32941,6868,230
23015,"Lincoln County, Maine",34415,34719,33616,30357,25691,8724,230
23017,"Oxford County, Maine",57741,57867,54755,52602,48968,8773,230
23019,"Penobscot County, Maine",151696,152934,144919,146601,137015,14681,230
23021,"Piscataquis County, Maine",16864,17555,17235,18653,17634,-770,230
23023,"Sagadahoc County, Maine",35720,35688,35214,33535,28795,6925,230
23025,"Somerset County, Maine",50573,52261,50888,49767,45028,5545,230
23027,"Waldo County, Maine",39723,38740,36280,33018,28414,11309,230
23029,"Washington County, Maine",31378,33154,33941,35308,34963,-3585,230
23031,"York County, Maine",206074,197457,186742,164587,139666,66408,230
24001,"Allegany County, Maryland",71002,74638,74930,74946,80548,-9546,249
24003,"Anne Arundel County, Maryland",575421,527020,489656,427239,370775,204646,241
24005,"Baltimore County, Maryland",828193,799195,754292,692134,655615,172578,241
24009,"Calvert County, Maryland",92094,87891,74563,51372,34638,57456,242
24011,"Caroline County, Maryland",33260,32805,29772,27035,23143,10117,249
24013,"Carroll County, Maryland",168233,167208,150897,123372,96356,71877,241
24015,"Cecil County, Maryland",102889,100139,85951,71347,60430,42459,249
24017,"Charles County, Maryland",161448,143912,120546,101154,72751,88697,242
24019,"Dorchester County, Maryland",31994,32287,30674,30236,30623,1371,249
24021,"Frederick County, Maryland",255955,229205,195277,150208,114792,141163,242
24023,"Garrett County, Maryland",29155,30145,29846,28138,26498,2657,249
24025,"Harford County, Maryland",253736,242888,218590,182132,145930,107806,241
24027,"Howard County, Maryland",322407,279366,247842,187328,118572,203835,241
24029,"Kent County, Maryland",19456,20018,19197,17842,16695,2761,249
24031,"Montgomery County, Maryland",1047661,947230,873341,757027,579053,468608,242
24033,"Prince George's County, Maryland",910551,854722,801515,729268,665071,245480,242
24035,"Queen Anne's County, Maryland",50163,46945,40563,33953,25508,24655,241
24037,"St. Mary's County, Maryland",113182,102086,86211,75974,59895,53287,249
24039,"Somerset County, Maryland",25699,26411,24747,23440,19188,6511,249
24041,"Talbot County, Maryland",37087,37361,33812,30549,25604,11483,249
24043,"Washington County, Maryland",150575,146329,131923,121393,113086,37489,249
24045,"Wicomico County, Maryland",103222,96951,84644,74339,64540,38682,249
24047,"Worcester County, Maryland",51967,51133,46543,35028,30889,21078,249
24510,"Baltimore City, Maryland",602274,620538,651154,736014,786775,-184501,241
25001,"Barnstable County, Massachusetts",213505,217483,222230,186605,147925,65580,259
25003,"Berkshire County, Massachusetts",125927,131528,134953,139352,145110,-19183,259
25005,"Bristol County, Massachusetts",563301,546433,534678,506325,474641,88660,251
25007,"Dukes County, Massachusetts",17430,16155,14987,11639,8942,8488,259
25009,"Essex County, Massachusetts",787038,735642,723419,670080,633632,153406,251
25011,"Franklin County, Massachusetts",70529,71523,71535,70092,64317,6212,259
25013,"Hampden County, Massachusetts",466647,462270,456228,456310,443018,23629,259
25015,"Hampshire County, Massachusetts",161361,157326,152251,146568,138813,22548,259
25017,"Middlesex County, Massachusetts",1605899,1479491,1465396,1398468,1367034,238865,251
25019,"Nantucket County, Massachusetts",11212,10069,9520,6012,5087,6125,259
25021,"Norfolk County, Massachusetts",703740,662077,650308,616087,606587,97153,251
25023,"Plymouth County, Massachusetts",518597,490784,472822,435276,405437,113160,251
25025,"Suffolk County, Massachusetts",801162,704460,689807,663906,650142,151020,251
25027,"Worcester County, Massachusetts",826655,791855,750963,709705,646352,180303,251
26001,"Alcona County, Michigan",10396,11238,11719,10145,9740,656,269
26003,"Alger County, Michigan",9098,9604,9862,8972,9225,-127,269
26005,"Allegan County, Michigan",117104,111385,105665,90509,81555,35549,262
26007,"Alpena County, Michigan",28431,29958,31314,30605,32315,-3884,269
26009,"Antrim County, Michigan",23301,23975,23110,18185,16194,7107,269
26011,"Arenac County, Michigan",15013,16487,17269,14931,14706,307,269
26013,"Baraga County, Michigan",8337,8882,8746,7954,8484,-147,269
26015,"Barry County, Michigan",61045,59576,56755,50057,45781,15264,262
26017,"Bay County, Michigan",103506,108156,110157,111723,119881,-16375,269
26019,"Benzie County, Michigan",17703,17705,15998,12200,11205,6498,269
26021,"Berrien County, Michigan",153797,157232,162453,161378,171276,-17479,269
26023,"Branch County, Michigan",43428,46083,45787,41502,40188,3240,269
26025,"Calhoun County, Michigan",133943,137112,137985,135982,141557,-7614,269
26027,"Cass County, Michigan",51613,52429,51104,49477,49499,2114,269
26029,"Charlevoix County, Michigan",26197,26228,26090,21468,19907,6290,269
26031,"Cheboygan County, Michigan",25435,26699,26448,21398,20649,4786,269
26033,"Chippewa County, Michigan",37418,39078,38543,34604,29029,8389,269
26035,"Clare County, Michigan",30655,31162,31252,24952,23822,6833,269
26037,"Clinton County, Michigan",78957,74235,64753,57883,55893,23064,269
26039,"Crawford County, Michigan",13904,14325,14273,12260,9465,4439,269
26041,"Delta County, Michigan",35874,37403,38520,37780,38947,-3073,269
26043,"Dickinson County, Michigan",25373,26584,27472,26831,25341,32,269
26045,"Eaton County, Michigan",109730,108002,103655,92879,88337,21393,269
26047,"Emmet County, Michigan",33175,32806,31437,25040,22992,10183,269
26049,"Genesee County, Michigan",406770,433054,436141,430459,450449,-43679,261
26051,"Gladwin County, Michigan",25312,26076,26023,21896,19957,5355,269
26053,"Gogebic County, Michigan",14715,16471,17370,18052,19686,-4971,269
26055,"Grand Traverse County, Michigan",92640,86061,77654,64273,54899,37741,269
26057,"Gratiot County, Michigan",40692,42612,42285,38982,40448,244,269
26059,"Hillsdale County, Michigan",45707,47033,46527,43431,42071,3636,269
26061,"Houghton County, Michigan",35890,36192,36016,35446,37872,-1982,269
26063,"Huron County, Michigan",31105,33642,36079,34951,36459,-5354,269
26065,"Ingham County, Michigan",290923,281365,279320,281912,275520,15403,269
26067,"Ionia County, Michigan",64401,64651,61518,57024,51815,12586,262
26069,"Iosco County, Michigan",25213,26422,27339,30209,28349,-3136,269
26071,"Iron County, Michigan",11099,12057,13138,13175,13635,-2536,269
26073,"Isabella County, Michigan",70363,69451,63351,54624,54110,16253,269
26075,"Jackson County, Michigan",158174,161569,158422,149756,151495,6679,269
26077,"Kalamazoo County, Michigan",264322,247246,238603,223411,212378,51944,269
26079,"Kalkaska County, Michigan",17725,17400,16571,13497,10952,6773,269
26081,"Kent County, Michigan",652617,599432,574335,500631,444506,208111,262
26083,"Keweenaw County, Michigan",2102,2122,2301,1701,1963,139,269
26085,"Lake County, Michigan",11805,11625,11333,8583,7711,4094,269
26087,"Lapeer County, Michigan",87975,89944,87904,74768,70038,17937,261
26089,"Leelanau County, Michigan",21649,21757,21119,16527,14007,7642,269
26091,"Lenawee County, Michigan",98310,100911,98890,91476,89948,8362,269
26093,"Livingston County, Michigan",190832,181350,156951,115645,100289,90543,261
26095,"Luce County, Michigan",6286,6685,7024,5763,6659,-373,269
26097,"Mackinac County, Michigan",10781,11281,11943,10674,10178,603,269
26099,"Macomb County, Michigan",870893,837490,788149,717400,694600,176293,261
26101,"Manistee County, Michigan",24539,24951,24527,21265,23019,1520,269
26103,"Marquette County, Michigan",66403,66514,64634,70887,74101,-7698,269
26105,"Mason County, Michigan",29062,28715,28274,25537,26365,2697,269
26107,"Mecosta County, Michigan",43481,42730,40553,37308,36961,6520,269
26109,"Menominee County, Michigan",22902,24245,25326,24920,26201,-3299,269
26111,"Midland County, Michigan",83445,83626,82874,75651,73578,9867,269
26113,"Missaukee County, Michigan",15075,14962,14478,12147,10009,5066,269
26115,"Monroe County, Michigan",150000,152784,145945,133600,134659,15341,261
26117,"Montcalm County, Michigan",63516,63553,61266,53059,47555,15961,269
26119,"Montmorency County, Michigan",9270,9920,10315,8936,7492,1778,269
26121,"Muskegon County, Michigan",173679,173223,170200,158983,157589,16090,262
26123,"Newaygo County, Michigan",48687,48962,47874,38202,34917,13770,262
26125,"Oakland County, Michigan",1255340,1201113,1194156,1083592,1011793,243547,261
26127,"Oceana County, Michigan",26545,27029,26873,22454,22002,4543,269
26129,"Ogemaw County, Michigan",20895,21862,21645,18681,16436,4459,269
26131,"Ontonagon County, Michigan",5802,6976,7818,8854,9861,-4059,269
26133,"Osceola County, Michigan",23323,23681,23197,20146,18928,4395,269
26135,"Oscoda County, Michigan",8282,8884,9418,7842,6858,1424,269
26137,"Otsego County, Michigan",24613,24445,23301,17957,14993,9620,269
26139,"Ottawa County, Michigan",289162,261376,238314,187768,157174,131988,262
26141,"Presque Isle County, Michigan",12687,13697,14411,13743,14267,-1580,269
26143,"Roscommon County, Michigan",23863,24932,25469,19776,16374,7489,269
26145,"Saginaw County, Michigan",191166,202336,210039,211946,228059,-36893,269
26147,"St. Clair County, Michigan",159285,165719,164235,145607,138802,20483,261
26149,"St. Joseph County, Michigan",60789,61848,62422,58913,56083,4706,269
26151,"Sanilac County, Michigan",41179,44010,44547,39928,40789,390,269
26153,"Schoolcraft County, Michigan",8031,8640,8903,8302,8575,-544,269
26155,"Shiawassee County, Michigan",68176,71621,71687,69770,71140,-2964,269
26157,"Tuscola County, Michigan",52683,56543,58266,55498,56961,-4278,269
26159,"Van Buren County, Michigan",75416,76585,76263,70060,66814,8602,269
26161,"Washtenaw County, Michigan",368385,343947,322895,282937,264748,103637,261
26163,"Wayne County, Michigan",1753059,1870362,2061162,2111687,2337891,-584832,261
26165,"Wexford County, Michigan",33433,32653,30484,26360,25102,8331,269
27001,"Aitkin County, Minnesota",15826,16325,15301,12425,13404,2422,279
27003,"Anoka County, Minnesota",353775,327544,298084,243641,195998,157777,271
27005,"Becker County, Minnesota",34227,32274,30000,27881,29336,4891,279
27007,"Beltrami County, Minnesota",46784,43781,39650,34384,30982,15802,279
27009,"Benton County, Minnesota",40476,38148,34226,30185,25187,15289,271
27011,"Big Stone County, Minnesota",4974,5324,5820,6285,7716,-2742,279
27013,"Blue Earth County, Minnesota",67368,62719,55941,54044,52314,15054,279
27015,"Brown County, Minnesota",25076,26030,26911,26984,28645,-3569,279
27017,"Carlton County, Minnesota",35709,34958,31671,29259,29936,5773,279
27019,"Carver County, Minnesota",103561,88668,70205,47915,37046,66515,271
27021,"Cass County, Minnesota",29462,28648,27150,21791,21050,8412,279
27023,"Chippewa County, Minnesota",11876,12426,13088,13228,14941,-3065,279
27025,"Chisago County, Minnesota",55844,52844,41101,30521,25717,30127,271
27027,"Clay County, Minnesota",64029,57089,51229,50422,49327,14702,279
27029,"Clearwater County, Minnesota",8872,8593,8423,8309,8761,111,279
27031,"Cook County, Minnesota",5402,5211,5168,3868,4092,1310,279
27033,"Cottonwood County, Minnesota",11279,11712,12167,12694,14854,-3575,279
27035,"Crow Wing County, Minnesota",64775,61836,55099,44249,41722,23053,279
27037,"Dakota County, Minnesota",425271,393380,355904,275227,194279,230992,271
27039,"Dodge County, Minnesota",20807,19829,17731,15731,14773,6034,279
27041,"Douglas County, Minnesota",37820,35909,32821,28674,27839,9981,279
27043,"Faribault County, Minnesota",13727,14819,16181,16937,19714,-5987,279
27045,"Fillmore County, Minnesota",21031,20978,21122,20777,21930,-899,279
27047,"Freeborn County, Minnesota",30465,31387,32584,33060,36329,-5864,279
27049,"Goodhue County, Minnesota",46330,45930,44127,40690,38749,7581,271
27051,"Grant County, Minnesota",5962,6082,6289,6246,7171,-1209,279
27053,"Hennepin County, Minnesota",1255296,1136522,1116200,1032431,941411,313885,271
27055,"Houston County, Minnesota",18670,19226,19718,18497,18382,288,279
27057,"Hubbard County, Minnesota",21287,20205,18376,14939,14098,7189,279
27059,"Isanti County, Minnesota",40004,37682,31287,25921,23600,16404,271
27061,"Itasca County, Minnesota",45180,44835,43992,40863,43069,2111,279
27063,"Jackson County, Minnesota",9873,10403,11268,11677,13690,-3817,279
27065,"Kanabec County, Minnesota",16205,16379,14996,12802,12161,4044,279
27067,"Kandiyohi County, Minnesota",42909,41869,41203,38761,36763,6146,279
27069,"Kittson County, Minnesota",4272,4620,5285,5767,6672,-2400,279
27071,"Koochiching County, Minnesota",12355,13461,14355,16299,17571,-5216,279
27073,"Lac Qui Parle County, Minnesota",6645,7343,8067,8924,10592,-3947,279
27075,"Lake County, Minnesota",10571,10900,11058,10415,13043,-2472,279
27077,"Lake Of The Woods County, Minnesota",3747,4147,4522,4076,3764,-17,279
27079,"Le Sueur County, Minnesota",28425,27719,25426,23239,23434,4991,279
27081,"Lincoln County, Minnesota",5641,5935,6429,6890,8207,-2566,279
27083,"Lyon County, Minnesota",25696,25606,25425,24789,25207,489,279
27085,"Mcleod County, Minnesota",35788,36789,34898,32030,29657,6131,271
27087,"Mahnomen County, Minnesota",5508,5359,5190,5044,5535,-27,279
27089,"Marshall County, Minnesota",9353,9580,10155,10993,13027,-3674,279
27091,"Martin County, Minnesota",19737,20865,21802,22914,24687,-4950,279
27093,"Meeker County, Minnesota",23149,23371,22644,20846,20594,2555,279
27095,"Mille Lacs County, Minnesota",25963,26075,22330,18670,18430,7533,279
27097,"Morrison County, Minnesota",33119,33093,31712,29604,29311,3808,279
27099,"Mower County, Minnesota",39931,38855,38603,37385,40390,-459,279
27101,"Murray County, Minnesota",8247,8779,9165,9660,11507,-3260,279
27103,"Nicollet County, Minnesota",34176,32271,29771,28076,26929,7247,279
27105,"Nobles County, Minnesota",21667,21030,20832,20098,21840,-173,279
27107,"Norman County, Minnesota",6466,6865,7442,7975,9379,-2913,279
27109,"Olmsted County, Minnesota",156446,141244,124277,106470,92006,64440,279
27111,"Otter Tail County, Minnesota",58416,57539,57159,50714,51937,6479,279
27113,"Pennington County, Minnesota",14110,13862,13584,13306,15258,-1148,279
27115,"Pine County, Minnesota",29254,29413,26530,21264,19871,9383,279
27117,"Pipestone County, Minnesota",9163,9570,9895,10491,11690,-2527,279
27119,"Polk County, Minnesota",31384,31336,31369,32498,34844,-3460,279
27121,"Pope County, Minnesota",11107,11064,11236,10745,11657,-550,279
27123,"Ramsey County, Minnesota",546598,503113,511035,485765,459784,86814,271
27125,"Red Lake County, Minnesota",4005,4094,4299,4525,5471,-1466,279
27127,"Redwood County, Minnesota",15193,16069,16815,17254,19341,-4148,279
27129,"Renville County, Minnesota",14572,16007,17154,17673,20401,-5829,279
27131,"Rice County, Minnesota",66549,63087,56665,49183,46087,20462,271
27133,"Rock County, Minnesota",9386,9606,9721,9806,10703,-1317,279
27135,"Roseau County, Minnesota",15259,15864,16338,15026,12574,2685,279
27137,"St. Louis County, Minnesota",199499,199472,200528,198213,222229,-22730,279
27139,"Scott County, Minnesota",147201,126139,89498,57846,43784,103417,271
27141,"Sherburne County, Minnesota",96015,86823,64417,41945,29908,66107,271
27143,"Sibley County, Minnesota",14871,15219,15356,14366,15448,-577,279
27145,"Stearns County, Minnesota",159788,147927,133166,118791,108161,51627,271
27147,"Steele County, Minnesota",36710,36434,33680,30729,30328,6382,279
27149,"Stevens County, Minnesota",9770,9711,10053,10634,11322,-1552,279
27151,"Swift County, Minnesota",9329,9946,11956,10724,12920,-3591,279
27153,"Todd County, Minnesota",24603,24804,24426,23363,24991,-388,279
27155,"Traverse County, Minnesota",3282,3657,4134,4463,5542,-2260,279
27157,"Wabasha County, Minnesota",21564,21743,21610,19744,19335,2229,279
27159,"Wadena County, Minnesota",13681,13809,13713,13154,14192,-511,279
27161,"Waseca County, Minnesota",18658,19168,19526,18079,18448,210,279
27163,"Washington County, Minnesota",259072,232536,201130,145896,113571,145501,271
27165,"Watonwan County, Minnesota",10903,11212,11876,11682,12361,-1458,279
27167,"Wilkin County, Minnesota",6264,6636,7138,7516,8454,-2190,279
27169,"Winona County, Minnesota",50744,51304,49985,47828,46256,4488,279
27171,"Wright County, Minnesota",136387,120764,89986,68710,58681,77706,271
27173,"Yellow Medicine County, Minnesota",9775,10514,11080,11684,13653,-3878,279
28001,"Adams County, Mississippi",31103,32659,34340,35356,38035,-6932,280
28003,"Alcorn County, Mississippi",37058,36708,34558,31722,33036,4022,280
28005,"Amite County, Mississippi",12341,13318,13599,13328,13369,-1028,280
28007,"Attala County, Mississippi",18308,19545,19661,18481,19865,-1557,280
28009,"Benton County, Mississippi",8275,8652,8026,8046,8153,122,280
28011,"Bolivar County, Mississippi",31253,35063,40633,41875,45965,-14712,280
28013,"Calhoun County, Mississippi",14417,14945,15069,14908,15664,-1247,280
28015,"Carroll County, Mississippi",9972,10608,10769,9237,9776,196,280
28017,"Chickasaw County, Mississippi",17060,17689,19440,18085,17853,-793,280
28019,"Choctaw County, Mississippi",8206,8680,9758,9071,8996,-790,280
28021,"Claiborne County, Mississippi",9042,9928,11831,11370,12279,-3237,280
28023,"Clarke County, Mississippi",15612,16808,17955,17313,16945,-1333,280
28025,"Clay County, Mississippi",19515,20883,21979,21120,21082,-1567,280
28027,"Coahoma County, Mississippi",22685,26681,30622,31665,36918,-14233,280
28029,"Copiah County, Mississippi",28339,29521,28757,27592,26503,1836,280
28031,"Covington County, Mississippi",18810,19557,19407,16527,15927,2883,280
28033,"De Soto County, Mississippi",182256,154715,107199,67910,53930,128326,280
28035,"Forrest County, Mississippi",75162,74290,72604,68314,66018,9144,280
28037,"Franklin County, Mississippi",7716,8130,8448,8377,8208,-492,280
28039,"George County, Mississippi",24098,22061,19144,16673,15297,8801,280
28041,"Greene County, Mississippi",13619,14009,13299,10220,9827,3792,280
28043,"Grenada County, Mississippi",20927,22169,23263,21555,21043,-116,280
28045,"Hancock County, Mississippi",47339,42408,42967,31760,24537,22802,280
28047,"Harrison County, Mississippi",206169,181791,189601,165365,157665,48504,280
28049,"Hinds County, Mississippi",235604,246067,250800,254441,250998,-15394,280
28051,"Holmes County, Mississippi",17414,19597,21609,21604,22970,-5556,280
28053,"Humphreys County, Mississippi",8198,9610,11206,12134,13931,-5733,280
28055,"Issaquena County, Mississippi",1223,1893,2274,1909,2513,-1290,280
28057,"Itawamba County, Mississippi",23396,23329,22770,20017,20518,2878,280
28059,"Jackson County, Mississippi",142872,137082,131420,115243,118015,24857,280
28061,"Jasper County, Mississippi",16454,17383,18149,17114,17265,-811,280
28063,"Jefferson County, Mississippi",7129,7970,9740,8653,9181,-2052,280
28065,"Jefferson Davis County, Mississippi",11182,12666,13962,14051,13846,-2664,280
28067,"Jones County, Mississippi",68307,67144,64958,62031,61912,6395,280
28069,"Kemper County, Mississippi",9829,10470,10453,10356,10148,-319,280
28071,"Lafayette County, Mississippi",54059,45859,38744,31826,31030,23029,280
28073,"Lamar County, Mississippi",62693,52559,39070,30424,23821,38872,280
28075,"Lauderdale County, Mississippi",75557,79405,78161,75555,77285,-1728,280
28077,"Lawrence County, Mississippi",12595,13016,13258,12458,12518,77,280
28079,"Leake County, Mississippi",22791,23547,20940,18436,18790,4001,280
28081,"Lee County, Mississippi",85304,81446,75755,65581,57061,28243,280
28083,"Leflore County, Mississippi",28764,33109,37947,37341,41525,-12761,280
28085,"Lincoln County, Mississippi",34197,34622,33166,30278,30174,4023,280
28087,"Lowndes County, Mississippi",58896,59482,61586,59308,57304,1592,280
28089,"Madison County, Mississippi",105482,91987,74674,53794,41613,63869,280
28091,"Marion County, Mississippi",24785,26758,25595,25544,25708,-923,280
28093,"Marshall County, Mississippi",35502,37002,34993,30361,29296,6206,280
28095,"Monroe County, Mississippi",35559,37282,38014,36582,36404,-845,280
28097,"Montgomery County, Mississippi",9956,11138,12189,12388,13366,-3410,280
28099,"Neshoba County, Mississippi",29250,29545,28684,24800,23789,5461,280
28101,"Newton County, Mississippi",21215,21828,21838,20291,19944,1271,280
28103,"Noxubee County, Mississippi",10566,11747,12548,12604,13212,-2646,280
28105,"Oktibbeha County, Mississippi",49593,46529,42902,38375,36018,13575,280
28107,"Panola County, Mississippi",34079,34782,34274,29996,28164,5915,280
28109,"Pearl River County, Mississippi",55512,55923,48621,38714,33795,21717,280
28111,"Perry County, Mississippi",11981,12243,12138,10865,9864,2117,280
28113,"Pike County, Mississippi",39365,40284,38940,36882,36173,3192,280
28115,"Pontotoc County, Mississippi",31996,29523,26726,22237,20918,11078,280
28117,"Prentiss County, Mississippi",25155,25411,25556,23278,24025,1130,280
28119,"Quitman County, Mississippi",7038,8551,10117,10490,12636,-5598,280
28121,"Rankin County, Mississippi",154119,138523,115327,87161,69427,84692,280
28123,"Scott County, Mississippi",28288,28180,28423,24137,24556,3732,280
28125,"Sharkey County, Mississippi",4427,4797,6580,7066,7964,-3537,280
28127,"Simpson County, Mississippi",26818,27575,27639,23953,23441,3377,280
28129,"Smith County, Mississippi",15919,16443,16182,14798,15077,842,280
28131,"Stone County, Mississippi",18282,16923,13622,10750,9716,8566,280
28133,"Sunflower County, Mississippi",25759,30504,34369,32867,34844,-9085,280
28135,"Tallahatchie County, Mississippi",14041,15270,14903,15210,17157,-3116,280
28137,"Tate County, Mississippi",28419,28198,25370,21432,20119,8300,280
28139,"Tippah County, Mississippi",21976,21993,20826,19523,18739,3237,280
28141,"Tishomingo County, Mississippi",19396,19535,19163,17683,18434,962,280
28143,"Tunica County, Mississippi",9807,10817,9227,8164,9652,155,280
28145,"Union County, Mississippi",28578,26922,25362,22085,21741,6837,280
28147,"Walthall County, Mississippi",14423,15530,15156,14352,13761,662,280
28149,"Warren County, Mississippi",46030,48890,49644,47880,51627,-5597,280
28151,"Washington County, Mississippi",45072,52455,62977,67935,72344,-27272,280
28153,"Wayne County, Mississippi",20344,20971,21216,19517,19135,1209,280
28155,"Webster County, Mississippi",9727,10139,10294,10222,10300,-573,280
28157,"Wilkinson County, Mississippi",8727,10070,10312,9678,10021,-1294,280
28159,"Winston County, Mississippi",18116,19378,20160,19433,19474,-1358,280
28161,"Yalobusha County, Mississippi",12276,12869,13051,12033,13139,-863,280
28163,"Yazoo County, Mississippi",28511,28402,28149,25506,27349,1162,280
29001,"Adair County, Missouri",25468,25315,24977,24577,24870,598,299
29003,"Andrew County, Missouri",17554,17006,16492,14632,13980,3574,299
29005,"Atchison County, Missouri",5180,5811,6430,7457,8605,-3425,299
29007,"Audrain County, Missouri",25336,25684,25853,23599,26458,-1122,299
29009,"Barry County, Missouri",35615,35753,34010,27547,24408,11207,299
29011,"Barton County, Missouri",11732,12634,12541,11312,11292,440,299
29013,"Bates County, Missouri",16282,17132,16653,15025,15873,409,291
29015,"Benton County, Missouri",19305,18975,17180,13859,12183,7122,299
29017,"Bollinger County, Missouri",12181,12445,12029,10619,10301,1880,299
29019,"Boone County, Missouri",179704,158067,135454,112379,100376,79328,299
29021,"Buchanan County, Missouri",87904,88195,85998,83083,87888,16,299
29023,"Butler County, Missouri",42570,42437,40867,38765,37693,4877,299
29025,"Caldwell County, Missouri",9052,9380,8969,8380,8660,392,291
29027,"Callaway County, Missouri",44944,43769,40766,32809,32252,12692,299
29029,"Camden County, Missouri",45823,43157,37051,27495,20017,25806,299
29031,"Cape Girardeau County, Missouri",78834,74283,68693,61633,58837,19997,299
29033,"Carroll County, Missouri",8723,9485,10285,10748,12131,-3408,299
29035,"Carter County, Missouri",6085,6141,5941,5515,5428,657,299
29037,"Cass County, Missouri",104687,97598,82092,63808,51029,53658,291
29039,"Cedar County, Missouri",14144,14091,13733,12093,11894,2250,299
29041,"Chariton County, Missouri",7449,7871,8438,9202,10489,-3040,299
29043,"Christian County, Missouri",87324,74156,54285,32644,22402,64922,299
29045,"Clark County, Missouri",6783,7169,7416,7547,8493,-1710,299
29047,"Clay County, Missouri",246480,215015,184006,153411,136488,109992,291
29049,"Clinton County, Missouri",20503,20682,18979,16595,15916,4587,291
29051,"Cole County, Missouri",76630,74767,71397,63579,56663,19967,299
29053,"Cooper County, Missouri",17522,17583,16670,14835,14643,2879,299
29055,"Crawford County, Missouri",23984,24640,22804,19173,18300,5684,299
29057,"Dade County, Missouri",7571,7929,7923,7449,7383,188,299
29059,"Dallas County, Missouri",16841,16813,15661,12646,12096,4745,299
29061,"Daviess County, Missouri",8294,8359,8016,7865,8905,-611,299
29063,"De Kalb County, Missouri",11872,12872,11597,9967,8222,3650,299
29065,"Dent County, Missouri",15518,15497,14927,13702,14517,1001,299
29067,"Douglas County, Missouri",13335,13689,13084,11876,11594,1741,299
29069,"Dunklin County, Missouri",29657,32140,33155,33112,36324,-6667,299
29071,"Franklin County, Missouri",103629,100737,93807,80603,71233,32396,292
29073,"Gasconade County, Missouri",14673,15334,15342,14006,13181,1492,299
29075,"Gentry County, Missouri",6576,6760,6861,6848,7887,-1311,299
29077,"Greene County, Missouri",291574,270190,240391,207949,185302,106272,299
29079,"Grundy County, Missouri",9885,10214,10432,10536,11959,-2074,299
29081,"Harrison County, Missouri",8427,8941,8850,8469,9890,-1463,299
29083,"Henry County, Missouri",21854,22373,21997,20044,19672,2182,299
29085,"Hickory County, Missouri",9452,9579,8940,7335,6367,3085,299
29087,"Holt County, Missouri",4374,4944,5351,6034,6882,-2508,299
29089,"Howard County, Missouri",10022,10120,10212,9631,10008,14,299
29091,"Howell County, Missouri",40130,39763,37238,31447,28807,11323,299
29093,"Iron County, Missouri",10150,10670,10697,10726,11084,-934,299
29095,"Jackson County, Missouri",700733,666997,654880,633232,629266,71467,291
29097,"Jasper County, Missouri",120528,115029,104686,90465,86958,33570,299
29099,"Jefferson County, Missouri",224777,216262,198099,171380,146183,78594,292
29101,"Johnson County, Missouri",53948,52041,48258,42514,39059,14889,291
29103,"Knox County, Missouri",3948,4134,4361,4482,5508,-1560,299
29105,"Laclede County, Missouri",35680,35357,32513,27158,24323,11357,299
29107,"Lafayette County, Missouri",32697,33313,32960,31107,29925,2772,291
29109,"Lawrence County, Missouri",38241,38373,35204,30236,28973,9268,299
29111,"Lewis County, Missouri",9898,10235,10494,10233,10901,-1003,299
29113,"Lincoln County, Missouri",57590,51333,38944,28892,22193,35397,292
29115,"Linn County, Missouri",12004,12824,13754,13885,15495,-3491,299
29117,"Livingston County, Missouri",14969,14961,14558,14592,15739,-770,299
29119,"Mcdonald County, Missouri",22882,23016,21681,16938,14917,7965,299
29121,"Macon County, Missouri",15154,15539,15762,15345,16313,-1159,299
29123,"Madison County, Missouri",12176,12269,11800,11127,10725,1451,299
29125,"Maries County, Missouri",8791,9203,8903,7976,7551,1240,299
29127,"Marion County, Missouri",28572,28579,28289,27682,28638,-66,299
29129,"Mercer County, Missouri",3623,3731,3757,3723,4685,-1062,299
29131,"Miller County, Missouri",25369,24805,23564,20700,18532,6837,299
29133,"Mississippi County, Missouri",13328,14143,13427,14442,15726,-2398,299
29135,"Moniteau County, Missouri",15907,15468,14827,12298,12068,3839,299
29137,"Monroe County, Missouri",8630,9078,9311,9104,9716,-1086,299
29139,"Montgomery County, Missouri",11414,12247,12136,11355,11537,-123,299
29141,"Morgan County, Missouri",20438,20631,19309,15574,13807,6631,299
29143,"New Madrid County, Missouri",17275,18847,19760,20928,22945,-5670,299
29145,"Newton County, Missouri",58288,57561,52636,44445,40555,17733,299
29147,"Nodaway County, Missouri",22199,23031,21912,21709,21996,203,299
29149,"Oregon County, Missouri",10561,10739,10344,9470,10238,323,299
29151,"Osage County, Missouri",13613,13768,13062,12018,12014,1599,299
29153,"Ozark County, Missouri",9138,9688,9542,8598,7961,1177,299
29155,"Pemiscot County, Missouri",16330,18587,20047,21921,24987,-8657,299
29157,"Perry County, Missouri",19227,18919,18132,16648,16784,2443,299
29159,"Pettis County, Missouri",42421,41587,39403,35437,36378,6043,299
29161,"Phelps County, Missouri",44587,44473,39825,35248,33633,10954,299
29163,"Pike County, Missouri",18158,18590,18351,15969,17568,590,299
29165,"Platte County, Missouri",102848,86894,73781,57867,46341,56507,291
29167,"Polk County, Missouri",32031,30729,26992,21826,18822,13209,299
29169,"Pulaski County, Missouri",52359,49114,41165,41307,42011,10348,299
29171,"Putnam County, Missouri",4746,5040,5223,5079,6092,-1346,299
29173,"Ralls County, Missouri",10258,10127,9626,8476,8911,1347,299
29175,"Randolph County, Missouri",24769,25495,24663,24370,25460,-691,299
29177,"Ray County, Missouri",22900,23667,23354,21971,21378,1522,291
29179,"Reynolds County, Missouri",6274,6698,6689,6661,7230,-956,299
29181,"Ripley County, Missouri",13484,14057,13509,12303,12458,1026,299
29183,"St. Charles County, Missouri",398472,350606,283883,212907,144107,254365,292
29185,"St. Clair County, Missouri",9455,9757,9652,8457,8622,833,299
29186,"Ste. Genevieve County, Missouri",17887,18205,17842,16037,15180,2707,299
29187,"St. Francois County, Missouri",66653,64239,55641,48904,42600,24053,292
29189,"St. Louis County, Missouri",996179,999454,1016315,993529,973896,22283,292
29195,"Saline County, Missouri",22932,23126,23756,23523,24919,-1987,299
29197,"Schuyler County, Missouri",4550,4361,4170,4236,4979,-429,299
29199,"Scotland County, Missouri",4923,4831,4983,4822,5415,-492,299
29201,"Scott County, Missouri",38538,39370,40422,39376,39647,-1109,299
29203,"Shannon County, Missouri",8207,8404,8324,7613,7885,322,299
29205,"Shelby County, Missouri",5975,6439,6799,6942,7826,-1851,299
29207,"Stoddard County, Missouri",29255,30089,29705,28895,29009,246,299
29209,"Stone County, Missouri",31875,32003,28658,19078,15587,16288,299
29211,"Sullivan County, Missouri",6163,6728,7219,6326,7434,-1271,299
29213,"Taney County, Missouri",55563,49324,39703,25561,20467,35096,299
29215,"Texas County, Missouri",25518,25662,23003,21476,21070,4448,299
29217,"Vernon County, Missouri",20560,20917,20454,19041,19806,754,299
29219,"Warren County, Missouri",35090,31635,24525,19534,14900,20190,292
29221,"Washington County, Missouri",24819,24981,23344,20380,17983,6836,292
29223,"Wayne County, Missouri",13058,13433,13259,11543,11277,1781,299
29225,"Webster County, Missouri",39127,35678,31045,23753,20414,18713,299
29227,"Worth County, Missouri",2001,2188,2382,2440,3008,-1007,299
29229,"Wright County, Missouri",18256,18731,17955,16758,16188,2068,299
29510,"St. Louis City, Missouri",304709,318809,348189,396685,453085,-148376,292
30001,"Beaverhead County, Montana",9454,9132,9202,8424,8186,1268,300
30003,"Big Horn County, Montana",13302,12663,12671,11337,11096,2206,300
30005,"Blaine County, Montana",6698,6472,7009,6728,6999,-301,300
30007,"Broadwater County, Montana",6080,5287,4385,3318,3267,2813,300
30009,"Carbon County, Montana",10689,9994,9552,8080,8099,2590,300
30011,"Carter County, Montana",1305,1289,1360,1503,1799,-494,300
30013,"Cascade County, Montana",81576,80562,80357,77691,80696,880,300
30015,"Chouteau County, Montana",5731,5765,5970,5452,6092,-361,300
30017,"Custer County, Montana",11563,11548,11696,11697,13109,-1546,300
30019,"Daniels County, Montana",1705,1649,2017,2266,2835,-1130,300
30021,"Dawson County, Montana",8824,8933,9059,9505,11805,-2981,300
30023,"Deer Lodge County, Montana",9153,9270,9417,10278,12518,-3365,300
30025,"Fallon County, Montana",2975,2813,2837,3103,3763,-788,300
30027,"Fergus County, Montana",11167,11513,11893,12083,13076,-1909,300
30029,"Flathead County, Montana",102001,89215,74471,59218,51966,50035,300
30031,"Gallatin County, Montana",111401,87676,67831,50463,42865,68536,300
30033,"Garfield County, Montana",1051,1224,1279,1589,1656,-605,300
30035,"Glacier County, Montana",13706,13251,13247,12121,10628,3078,300
30037,"Golden Valley County, Montana",814,810,1042,912,1026,-212,300
30039,"Granite County, Montana",3325,3044,2830,2548,2700,625,300
30041,"Hill County, Montana",16422,16007,16673,17654,17985,-1563,300
30043,"Jefferson County, Montana",12069,11166,10049,7939,7029,5040,300
30045,"Judith Basin County, Montana",1968,1967,2329,2282,2646,-678,300
30047,"Lake County, Montana",30383,28493,26507,21041,19056,11327,300
30049,"Lewis And Clark County, Montana",68714,61643,55716,47495,43039,25675,300
30051,"Liberty County, Montana",2455,2261,2158,2295,2329,126,300
30053,"Lincoln County, Montana",19845,19507,18837,17481,17752,2093,300
30055,"Mccone County, Montana",1826,1714,1977,2276,2702,-876,300
30057,"Madison County, Montana",8530,7588,6851,5989,5448,3082,300
30059,"Meagher County, Montana",1795,2024,1932,1819,2154,-359,300
30061,"Mineral County, Montana",4330,4193,3884,3315,3675,655,300
30063,"Missoula County, Montana",119062,107288,95802,78687,76016,43046,300
30065,"Musselshell County, Montana",4682,4339,4497,4106,4428,254,300
30067,"Park County, Montana",16513,15752,15694,14562,12660,3853,300
30069,"Petroleum County, Montana",464,598,493,519,655,-191,300
30071,"Phillips County, Montana",4032,4206,4601,5163,5367,-1335,300
30073,"Pondera County, Montana",5911,6145,6424,6433,6731,-820,300
30075,"Powder River County, Montana",1634,1659,1858,2090,2520,-886,300
30077,"Powell County, Montana",6843,7077,7180,6620,6958,-115,300
30079,"Prairie County, Montana",1162,1089,1199,1383,1836,-674,300
30081,"Ravalli County, Montana",43424,40013,36070,25010,22493,20931,300
30083,"Richland County, Montana",11097,9498,9667,10716,12243,-1146,300
30085,"Roosevelt County, Montana",11091,10273,10620,10999,10467,624,300
30087,"Rosebud County, Montana",9065,9134,9383,10505,9899,-834,300
30089,"Sanders County, Montana",11804,11366,10227,8669,8675,3129,300
30091,"Sheridan County, Montana",3389,3505,4105,4732,5414,-2025,300
30093,"Silver Bow County, Montana",34895,33797,34606,33941,38092,-3197,300
30095,"Stillwater County, Montana",9562,8934,8195,6536,5598,3964,300
30097,"Sweet Grass County, Montana",3676,3717,3609,3154,3216,460,300
30099,"Teton County, Montana",6127,6105,6445,6271,6491,-364,300
30101,"Toole County, Montana",4812,5143,5267,5046,5559,-747,300
30103,"Treasure County, Montana",614,848,861,874,981,-367,300
30105,"Valley County, Montana",7424,7345,7675,8239,10250,-2826,300
30107,"Wheatland County, Montana",2138,2118,2259,2246,2359,-221,300
30109,"Wibaux County, Montana",1037,1067,1068,1191,1476,-439,300
30111,"Yellowstone County, Montana",160390,144050,129352,113419,108035,52355,300
31001,"Adams County, Nebraska",31541,31126,31151,29625,30656,885,310
31003,"Antelope County, Nebraska",6315,6742,7452,7965,8675,-2360,310
31005,"Arthur County, Nebraska",439,426,444,462,513,-74,310
31007,"Banner County, Nebraska",645,720,819,852,918,-273,310
31009,"Blaine County, Nebraska",467,539,583,675,867,-400,310
31011,"Boone County, Nebraska",5228,5553,6259,6667,7391,-2163,310
31013,"Box Butte County, Nebraska",10845,11372,12158,13130,13696,-2851,310
31015,"Boyd County, Nebraska",1882,2107,2438,2835,3331,-1449,310
31017,"Brown County, Nebraska",2887,3192,3525,3657,4377,-1490,310
31019,"Buffalo County, Nebraska",49594,45437,42259,37447,34797,14797,310
31021,"Burt County, Nebraska",6503,6964,7791,7868,8813,-2310,310
31023,"Butler County, Nebraska",7997,8382,8767,8601,9330,-1333,310
31025,"Cass County, Nebraska",26022,25246,24334,21318,20297,5725,310
31027,"Cedar County, Nebraska",8483,8906,9615,10131,11375,-2892,310
31029,"Chase County, Nebraska",3707,3927,4068,4381,4758,-1051,310
31031,"Cherry County, Nebraska",5801,5783,6148,6307,6758,-957,310
31033,"Cheyenne County, Nebraska",9428,10049,9830,9494,10057,-629,310
31035,"Clay County, Nebraska",6193,6554,7039,7123,8106,-1913,310
31037,"Colfax County, Nebraska",10681,10201,10441,9139,9890,791,310
31039,"Cuming County, Nebraska",8882,9243,10203,10117,11664,-2782,310
31041,"Custer County, Nebraska",10788,11001,11793,12270,13877,-3089,310
31043,"Dakota County, Nebraska",20124,20674,20253,16742,16573,3551,310
31045,"Dawes County, Nebraska",8685,9149,9060,9021,9609,-924,310
31047,"Dawson County, Nebraska",23638,24245,24365,19940,22304,1334,310
31049,"Deuel County, Nebraska",1770,1963,2098,2237,2462,-692,310
31051,"Dixon County, Nebraska",5682,6000,6339,6143,7137,-1455,310
31053,"Dodge County, Nebraska",36565,36621,36160,34500,35847,718,310
31055,"Douglas County, Nebraska",565739,505545,463585,416444,397038,168701,310
31057,"Dundy County, Nebraska",1928,1963,2292,2582,2861,-933,310
31059,"Fillmore County, Nebraska",5542,5953,6634,7103,7920,-2378,310
31061,"Franklin County, Nebraska",2970,3229,3574,3938,4377,-1407,310
31063,"Frontier County, Nebraska",2636,2808,3099,3101,3647,-1011,310
31065,"Furnas County, Nebraska",4712,4942,5324,5553,6486,-1774,310
31067,"Gage County, Nebraska",21548,22591,22993,22794,24456,-2908,310
31069,"Garden County, Nebraska",1916,2060,2292,2460,2802,-886,310
31071,"Garfield County, Nebraska",2081,2081,1902,2141,2363,-282,310
31073,"Gosper County, Nebraska",2001,2058,2143,1928,2140,-139,310
31075,"Grant County, Nebraska",691,661,747,769,877,-186,310
31077,"Greeley County, Nebraska",2361,2542,2714,3006,3462,-1101,310
31079,"Hall County, Nebraska",61338,56899,53534,48925,47690,13648,310
31081,"Hamilton County, Nebraska",9219,9160,9403,8862,9301,-82,310
31083,"Harlan County, Nebraska",3380,3460,3786,3810,4292,-912,310
31085,"Hayes County, Nebraska",889,1025,1068,1222,1356,-467,310
31087,"Hitchcock County, Nebraska",2788,2925,3111,3750,4079,-1291,310
31089,"Holt County, Nebraska",10123,10479,11551,12599,13552,-3429,310
31091,"Hooker County, Nebraska",741,690,783,793,990,-249,310
31093,"Howard County, Nebraska",6428,6302,6567,6055,6773,-345,310
31095,"Jefferson County, Nebraska",7102,7708,8333,8759,9817,-2715,310
31097,"Johnson County, Nebraska",5118,5211,4488,4673,5285,-167,310
31099,"Kearney County, Nebraska",6588,6552,6882,6629,7053,-465,310
31101,"Keith County, Nebraska",8048,8356,8875,8584,9364,-1316,310
31103,"Keya Paha County, Nebraska",875,740,983,1029,1301,-426,310
31105,"Kimball County, Nebraska",3576,3814,4089,4108,4882,-1306,310
31107,"Knox County, Nebraska",8400,8762,9374,9534,11457,-3057,310
31109,"Lancaster County, Nebraska",315976,279428,250291,213641,192884,123092,310
31111,"Lincoln County, Nebraska",35042,36167,34632,32508,36455,-1413,310
31113,"Logan County, Nebraska",896,682,774,878,983,-87,310
31115,"Loup County, Nebraska",690,635,712,683,859,-169,310
31117,"Mcpherson County, Nebraska",420,489,533,546,593,-173,310
31119,"Madison County, Nebraska",35023,34720,35226,32655,31382,3641,310
31121,"Merrick County, Nebraska",7826,7784,8204,8042,8945,-1119,310
31123,"Morrill County, Nebraska",4711,5071,5440,5423,6085,-1374,310
31125,"Nance County, Nebraska",3525,3755,4038,4275,4740,-1215,310
31127,"Nemaha County, Nebraska",6978,7249,7576,7980,8367,-1389,310
31129,"Nuckolls County, Nebraska",4204,4583,5057,5786,6726,-2522,310
31131,"Otoe County, Nebraska",15965,15741,15396,14252,15183,782,310
31133,"Pawnee County, Nebraska",2640,2767,3087,3317,3937,-1297,310
31135,"Perkins County, Nebraska",2889,2983,3200,3367,3637,-748,310
31137,"Phelps County, Nebraska",9050,9234,9747,9715,9769,-719,310
31139,"Pierce County, Nebraska",7132,7308,7857,7827,8481,-1349,310
31141,"Platte County, Nebraska",33250,31675,31662,29820,28852,4398,310
31143,"Polk County, Nebraska",5208,5412,5639,5675,6320,-1112,310
31145,"Red Willow County, Nebraska",10725,11069,11448,11705,12615,-1890,310
31147,"Richardson County, Nebraska",7913,8455,9531,9937,11315,-3402,310
31149,"Rock County, Nebraska",1430,1651,1756,2019,2383,-953,310
31151,"Saline County, Nebraska",14221,14098,13843,12715,13131,1090,310
31153,"Sarpy County, Nebraska",183956,152180,122595,102583,86015,97941,310
31155,"Saunders County, Nebraska",21356,20543,19830,18285,18716,2640,310
31157,"Scotts Bluff County, Nebraska",35884,36569,36951,36025,38344,-2460,310
31159,"Seward County, Nebraska",17217,16628,16496,15450,15789,1428,310
31161,"Sheridan County, Nebraska",5215,5538,6198,6750,7544,-2329,310
31163,"Sherman County, Nebraska",3015,3144,3318,3718,4226,-1211,310
31165,"Sioux County, Nebraska",1298,1340,1475,1549,1845,-547,310
31167,"Stanton County, Nebraska",5946,6207,6455,6244,6549,-603,310
31169,"Thayer County, Nebraska",5000,5262,6055,6635,7582,-2582,310
31171,"Thomas County, Nebraska",586,756,729,851,973,-387,310
31173,"Thurston County, Nebraska",7218,6907,7171,6936,7186,32,310
31175,"Valley County, Nebraska",4100,4284,4647,5169,5633,-1533,310
31177,"Washington County, Nebraska",20546,20148,18780,16607,15508,5038,310
31179,"Wayne County, Nebraska",9388,9573,9851,9364,9858,-470,310
31181,"Webster County, Nebraska",3497,3815,4061,4279,4858,-1361,310
31183,"Wheeler County, Nebraska",689,751,886,948,1060,-371,310
31185,"York County, Nebraska",13671,13886,14598,14428,14798,-1127,310
32001,"Churchill County, Nevada",24606,24946,23982,17938,13917,10689,329
32003,"Clark County, Nevada",2228866,1895521,1375765,741459,463087,1765779,321
32005,"Douglas County, Nevada",48486,47042,41259,27637,19421,29065,329
32007,"Elko County, Nevada",52537,47707,45291,33530,17269,35268,329
32009,"Esmeralda County, Nevada",1030,892,971,1344,777,253,329
32011,"Eureka County, Nevada",1839,1724,1651,1547,1198,641,329
32013,"Humboldt County, Nevada",16834,15986,16106,12844,9434,7400,329
32015,"Lander County, Nevada",5565,5545,5794,6266,4076,1489,329
32017,"Lincoln County, Nevada",5177,5060,4165,3775,3732,1445,329
32019,"Lyon County, Nevada",55667,51515,34501,20001,13594,42073,329
32021,"Mineral County, Nevada",4487,4812,5071,6475,6217,-1730,329
32023,"Nye County, Nevada",45514,43878,32485,17781,9048,36466,321
32027,"Pershing County, Nevada",6591,6703,6693,4336,3408,3183,329
32029,"Storey County, Nevada",4086,4016,3399,2526,1503,2583,329
32031,"Washoe County, Nevada",464182,412844,339486,254667,193623,270559,329
32033,"White Pine County, Nevada",9570,9765,9181,9264,8167,1403,329
32510,"Carson City, Nevada",55244,55375,52457,40443,32022,23222,329
33001,"Belknap County, New Hampshire",61174,60142,56325,49216,42884,18290,330
33003,"Carroll County, New Hampshire",48461,47772,43666,35410,27931,20530,330
33005,"Cheshire County, New Hampshire",76040,77445,73825,70121,62116,13924,330
33007,"Coos County, New Hampshire",31486,33445,33111,34828,35147,-3661,330
33009,"Grafton County, New Hampshire",90331,88356,81743,74929,65806,24525,330
33011,"Hillsborough County, New Hampshire",415305,399555,380841,336073,276608,138697,330
33013,"Merrimack County, New Hampshire",150902,146785,136225,120005,98302,52600,330
33015,"Rockingham County, New Hampshire",308211,294638,277359,245845,190345,117866,330
33017,"Strafford County, New Hampshire",130161,122158,112233,104233,85408,44753,330
33019,"Sullivan County, New Hampshire",43173,43643,40458,38592,36063,7110,330
34001,"Atlantic County, New Jersey",264650,273162,252552,224327,194119,70531,349
34003,"Bergen County, New Jersey",931275,896482,884118,825380,845385,85890,341
34005,"Burlington County, New Jersey",446301,447861,423394,395066,362542,83759,342
34007,"Camden County, New Jersey",506721,513574,508932,502824,471650,35071,342
34009,"Cape May County, New Jersey",92701,97684,102326,95089,82266,10435,349
34011,"Cumberland County, New Jersey",150085,155456,146438,138053,132866,17219,342
34013,"Essex County, New Jersey",798698,780872,793633,778206,851116,-52418,341
34015,"Gloucester County, New Jersey",291745,285223,254673,230082,199917,91828,342
34017,"Hudson County, New Jersey",671923,622123,608975,553099,556972,114951,341
34019,"Hunterdon County, New Jersey",125063,128458,121989,107776,87361,37702,341
34021,"Mercer County, New Jersey",368085,364445,350761,325824,307863,60222,341
34023,"Middlesex County, New Jersey",825015,798882,750162,671780,595893,229122,341
34025,"Monmouth County, New Jersey",620821,628112,615301,553124,503173,117648,341
34027,"Morris County, New Jersey",492715,489811,470212,421353,407630,85085,341
34029,"Ocean County, New Jersey",602018,569374,510916,433203,346038,255980,341
34031,"Passaic County, New Jersey",502763,496204,489049,453060,447585,55178,341
34033,"Salem County, New Jersey",62754,65982,64285,65294,64676,-1922,342
34035,"Somerset County, New Jersey",330151,319347,297490,240279,203129,127022,341
34037,"Sussex County, New Jersey",140996,149996,144166,130943,116119,24877,341
34039,"Union County, New Jersey",555208,529547,522541,493819,504094,51114,341
34041,"Warren County, New Jersey",105730,108982,102437,91607,84429,21301,349
35001,"Bernalillo County, New Mexico",679037,646881,556678,480577,419700,259337,350
35003,"Catron County, New Mexico",3547,3652,3543,2563,2720,827,350
35005,"Chaves County, New Mexico",64912,64268,61382,57849,51103,13809,350
35007,"Colfax County, New Mexico",12106,13827,14189,12925,13667,-1561,350
35009,"Curry County, New Mexico",49502,46924,45044,42207,42019,7483,350
35011,"De Baca County, New Mexico",1995,1772,2240,2252,2454,-459,350
35013,"Dona Ana County, New Mexico",217696,201670,174682,135510,96340,121356,350
35015,"Eddy County, New Mexico",57865,52665,51658,48605,47855,10010,350
35017,"Grant County, New Mexico",27391,29706,31002,27676,26204,1187,350
35019,"Guadalupe County, New Mexico",4336,4698,4680,4156,4496,-160,350
35021,"Harding County, New Mexico",432,943,810,987,1090,-658,350
35023,"Hidalgo County, New Mexico",4234,4964,5932,5958,6049,-1815,350
35025,"Lea County, New Mexico",70359,62503,55511,55765,55993,14366,350
35027,"Lincoln County, New Mexico",19640,20502,19411,12219,10997,8643,350
35028,"Los Alamos County, New Mexico",18976,18091,18343,18115,17599,1377,350
35029,"Luna County, New Mexico",24022,25252,25016,18110,15585,8437,350
35031,"Mckinley County, New Mexico",71956,70663,74798,60686,56449,15507,350
35033,"Mora County, New Mexico",4500,4923,5180,4264,4205,295,350
35035,"Otero County, New Mexico",66804,62782,62298,51928,44665,22139,350
35037,"Quay County, New Mexico",8265,9002,10155,10823,10577,-2312,350
35039,"Rio Arriba County, New Mexico",38962,40195,41190,34365,29282,9680,350
35041,"Roosevelt County, New Mexico",18723,19372,18018,16702,15695,3028,350
35043,"Sandoval County, New Mexico",144954,124263,89908,63319,34799,110155,350
35045,"San Juan County, New Mexico",125608,127517,113801,91605,81433,44175,350
35047,"San Miguel County, New Mexico",27546,29321,30126,25743,22751,4795,350
35049,"Santa Fe County, New Mexico",150319,141702,129292,98928,75360,74959,350
35051,"Sierra County, New Mexico",10988,11938,13270,9912,8454,2534,350
35053,"Socorro County, New Mexico",16723,17964,18078,14764,12566,4157,350
35055,"Taos County, New Mexico",32759,32574,29979,23118,19456,13303,350
35057,"Torrance County, New Mexico",15477,16467,16911,10285,7491,7986,350
35059,"Union County, New Mexico",4106,4388,4174,4124,4725,-619,350
35061,"Valencia County, New Mexico",76518,74554,66152,45235,61115,15403,350
36001,"Albany County, New York",306165,304032,294565,292594,285909,20256,361
36003,"Allegany County, New York",46304,49105,49927,50470,51742,-5438,369
36005,"Bronx County, New York",1427056,1365725,1332650,1203789,1168972,258084,363
36007,"Broome County, New York",192042,200804,200536,212160,213648,-21606,369
36009,"Cattaraugus County, New York",76750,80776,83955,84234,85697,-8947,362
36011,"Cayuga County, New York",76958,80431,81963,82313,79894,-2936,369
36013,"Chautauqua County, New York",127584,135263,139750,141895,146925,-19341,369
36015,"Chemung County, New York",84115,88708,91070,95195,97656,-13541,369
36017,"Chenango County, New York",47527,51045,51401,51768,49344,-1817,369
36019,"Clinton County, New York",80320,82380,79894,85969,80750,-430,369
36021,"Columbia County, New York",60016,63241,63094,62982,59487,529,361
36023,"Cortland County, New York",47618,49452,48599,48963,48820,-1202,369
36025,"Delaware County, New York",44676,48220,48055,47225,46824,-2148,369
36027,"Dutchess County, New York",293524,296152,280150,259462,245055,48469,363
36029,"Erie County, New York",918873,921202,950265,968532,1015472,-96599,362
36031,"Essex County, New York",37281,39416,38851,37152,36176,1105,369
36033,"Franklin County, New York",50389,51697,51134,46540,44929,5460,369
36035,"Fulton County, New York",53452,55497,55073,54191,55153,-1701,361
36037,"Genesee County, New York",57554,59952,60370,60060,59400,-1846,364
36039,"Greene County, New York",47335,49410,48195,44739,40861,6474,369
36041,"Hamilton County, New York",4454,4908,5379,5279,5034,-580,369
36043,"Herkimer County, New York",61738,64332,64427,65797,66714,-4976,369
36045,"Jefferson County, New York",111454,115069,111738,110943,88151,23303,369
36047,"Kings County, New York",2576771,2466782,2465326,2300664,2230936,345835,363
36049,"Lewis County, New York",26456,27017,26944,26796,25035,1421,369
36051,"Livingston County, New York",63218,65441,64328,62372,57006,6212,364
36053,"Madison County, New York",70990,72887,69441,69120,65150,5840,369
36055,"Monroe County, New York",743084,741274,735343,713968,702238,40846,364
36057,"Montgomery County, New York",49294,49945,49708,51981,53439,-4145,361
36059,"Nassau County, New York",1355683,1329083,1334544,1287348,1321582,34101,363
36061,"New York County, New York",1629153,1583345,1537195,1487536,1428285,200868,363
36063,"Niagara County, New York",210145,216064,219846,220756,227354,-17209,362
36065,"Oneida County, New York",229074,234533,235469,250836,253466,-24392,369
36067,"Onondaga County, New York",461591,463704,458336,468973,463920,-2329,369
36069,"Ontario County, New York",109774,106298,100224,95101,88909,20865,364
36071,"Orange County, New York",382077,370201,341367,307647,259603,122474,363
36073,"Orleans County, New York",40624,43169,44171,41846,38496,2128,364
36075,"Oswego County, New York",117630,122220,122377,121771,113901,3729,369
36077,"Otsego County, New York",59593,62604,61676,60517,59075,518,369
36079,"Putnam County, New York",98714,99545,95745,83941,77193,21521,363
36081,"Queens County, New York",2270976,2199169,2229379,1951598,1891325,379651,363
36083,"Rensselaer County, New York",159013,158629,152538,154429,151966,7047,361
36085,"Richmond County, New York",475596,463450,443728,378977,352121,123475,363
36087,"Rockland County, New York",325213,305461,286753,265475,259530,65683,363
36089,"St. Lawrence County, New York",108352,111778,111931,111974,114254,-5902,369
36091,"Saratoga County, New York",229313,217264,200635,181276,153759,75554,361
36093,"Schenectady County, New York",155086,153268,146555,149285,149946,5140,361
36095,"Schoharie County, New York",31189,32789,31582,31859,29710,1479,361
36097,"Schuyler County, New York",17845,18566,19224,18662,17686,159,369
36099,"Seneca County, New York",34295,35309,33342,33683,33733,562,364
36101,"Steuben County, New York",95843,98724,98726,99088,99217,-3374,369
36103,"Suffolk County, New York",1481364,1482548,1419369,1321864,1284231,197133,363
36105,"Sullivan County, New York",75329,77625,73966,69277,65155,10174,369
36107,"Tioga County, New York",48431,51377,51784,52337,49812,-1381,369
36109,"Tompkins County, New York",102237,100612,96501,94097,87085,15152,369
36111,"Ulster County, New York",178371,182782,177749,165304,158158,20213,363
36113,"Warren County, New York",64187,65707,63303,59209,54854,9333,361
36115,"Washington County, New York",61304,63088,61042,59330,54795,6509,361
36117,"Wayne County, New York",90103,93654,93765,89123,84581,5522,364
36119,"Westchester County, New York",968738,939406,923459,874866,866599,102139,363
36121,"Wyoming County, New York",40027,42367,43424,42507,39895,132,369
36123,"Yates County, New York",24981,25250,24621,22810,21459,3522,369
37001,"Alamance County, North Carolina",166144,147072,130800,108213,99319,66825,372
37003,"Alexander County, North Carolina",37271,36797,33603,27544,24999,12272,379
37005,"Alleghany County, North Carolina",11085,11084,10677,9590,9587,1498,379
37007,"Anson County, North Carolina",24430,26785,25275,23474,25649,-1219,371
37009,"Ashe County, North Carolina",27009,26787,24384,22209,22325,4684,379
37011,"Avery County, North Carolina",17510,17951,17167,14867,14409,3101,379
37013,"Beaufort County, North Carolina",47160,47185,44958,42283,40355,6805,379
37015,"Bertie County, North Carolina",19081,20890,19773,20388,21024,-1943,379
37017,"Bladen County, North Carolina",33209,34629,32278,28663,30491,2718,379
37019,"Brunswick County, North Carolina",137303,101994,73143,50985,35777,101526,379
37021,"Buncombe County, North Carolina",259576,233249,206330,174821,160934,98642,379
37023,"Burke County, North Carolina",90148,90557,89148,75744,72504,17644,379
37025,"Cabarrus County, North Carolina",211605,169990,131063,98935,85895,125710,371
37027,"Caldwell County, North Carolina",82056,82162,77415,70709,67746,14310,379
37029,"Camden County, North Carolina",10654,9719,6885,5904,5829,4825,379
37031,"Carteret County, North Carolina",69301,65068,59383,52556,41092,28209,379
37033,"Caswell County, North Carolina",22619,23848,23501,20693,20705,1914,379
37035,"Catawba County, North Carolina",158507,153149,141685,118412,105208,53299,379
37037,"Chatham County, North Carolina",72853,61426,49329,38759,33415,39438,373
37039,"Cherokee County, North Carolina",28413,27317,24298,20170,18933,9480,379
37041,"Chowan County, North Carolina",13995,14859,14526,13506,12558,1437,379
37043,"Clay County, North Carolina",11150,10418,8775,7155,6619,4531,379
37045,"Cleveland County, North Carolina",97765,97786,96287,84714,83435,14330,371
37047,"Columbus County, North Carolina",55659,56856,54749,49587,51037,4622,379
37049,"Craven County, North Carolina",102290,100001,91436,81613,71043,31247,379
37051,"Cumberland County, North Carolina",334562,312994,302963,274566,247160,87402,379
37053,"Currituck County, North Carolina",27210,23299,18190,13736,11089,16121,379
37055,"Dare County, North Carolina",36698,33650,29967,22746,13377,23321,379
37057,"Davidson County, North Carolina",166837,160638,147246,126677,113162,53675,372
37059,"Davie County, North Carolina",42543,40581,34835,27859,24599,17944,372
37061,"Duplin County, North Carolina",58965,56657,49063,39995,40952,18013,379
37063,"Durham County, North Carolina",317665,258578,223314,181835,152785,164880,373
37065,"Edgecombe County, North Carolina",52069,56247,55606,56558,55988,-3919,379
37067,"Forsyth County, North Carolina",378499,342989,306067,265878,243683,134816,372
37069,"Franklin County, North Carolina",68027,58473,47260,36414,30055,37972,373
37071,"Gaston County, North Carolina",222119,202642,190365,175093,162568,59551,371
37073,"Gates County, North Carolina",11519,12039,10516,9305,8875,2644,379
37075,"Graham County, North Carolina",8501,8702,7993,7196,7217,1284,379
37077,"Granville County, North Carolina",59823,58071,48498,38345,34043,25780,379
37079,"Greene County, North Carolina",20987,21157,18974,15384,16117,4870,379
37081,"Guilford County, North Carolina",532956,475786,421048,347420,317154,215802,372
37083,"Halifax County, North Carolina",50678,55293,57370,55516,55286,-4608,379
37085,"Harnett County, North Carolina",134328,109031,91025,67822,59570,74758,373
37087,"Haywood County, North Carolina",61862,58597,54033,46942,46495,15367,379
37089,"Henderson County, North Carolina",116298,103881,89173,69285,58580,57718,379
37091,"Hertford County, North Carolina",23752,24384,22601,22523,23368,384,379
37093,"Hoke County, North Carolina",54590,44128,33646,22856,20383,34207,379
37095,"Hyde County, North Carolina",5089,5721,5826,5411,5873,-784,379
37097,"Iredell County, North Carolina",178853,154632,122660,92931,82538,96315,371
37099,"Jackson County, North Carolina",43435,39144,33121,26846,25811,17624,379
37101,"Johnston County, North Carolina",203308,160675,121965,81306,70599,132709,373
37103,"Jones County, North Carolina",9453,10060,10381,9414,9705,-252,379
37105,"Lee County, North Carolina",61083,55576,49040,41374,36718,24365,379
37107,"Lenoir County, North Carolina",56350,59307,59648,57274,59819,-3469,379
37109,"Lincoln County, North Carolina",84580,75697,63780,50319,42372,42208,371
37111,"Mcdowell County, North Carolina",45402,44593,42151,35681,35135,10267,379
37113,"Macon County, North Carolina",35172,33453,29811,23499,20178,14994,379
37115,"Madison County, North Carolina",21608,20549,19635,16953,16827,4781,379
37117,"Martin County, North Carolina",22644,24471,25593,25078,25948,-3304,379
37119,"Mecklenburg County, North Carolina",1095170,882761,695454,511433,404270,690900,371
37121,"Mitchell County, North Carolina",14959,15680,15687,14433,14428,531,379
37123,"Montgomery County, North Carolina",27223,27611,26822,23346,22469,4754,379
37125,"Moore County, North Carolina",99263,85914,74769,59013,50505,48758,379
37127,"Nash County, North Carolina",94287,94402,87420,76677,67153,27134,379
37129,"New Hanover County, North Carolina",231448,197272,160307,120284,103471,127977,379
37131,"Northampton County, North Carolina",19672,22161,22086,20798,22584,-2912,379
37133,"Onslow County, North Carolina",198377,169207,150355,149838,112784,85593,379
37135,"Orange County, North Carolina",146354,129562,118227,93851,77055,69299,373
37137,"Pamlico County, North Carolina",12673,13072,12934,11372,10398,2275,379
37139,"Pasquotank County, North Carolina",39775,40167,34897,31298,28462,11313,379
37141,"Pender County, North Carolina",61891,50256,41082,28855,22215,39676,379
37143,"Perquimans County, North Carolina",13513,13091,11368,10447,9486,4027,379
37145,"Person County, North Carolina",39561,38942,35623,30180,29164,10397,373
37147,"Pitt County, North Carolina",179961,161385,133798,107924,90146,89815,379
37149,"Polk County, North Carolina",20682,20289,18324,14416,12984,7698,379
37151,"Randolph County, North Carolina",143460,140034,130454,106546,91728,51732,372
37153,"Richmond County, North Carolina",44759,46477,46564,44518,45481,-722,379
37155,"Robeson County, North Carolina",131656,131708,123339,105179,101610,30046,379
37157,"Rockingham County, North Carolina",91051,93322,91928,86064,83426,7625,372
37159,"Rowan County, North Carolina",140978,136880,130340,110605,99186,41792,371
37161,"Rutherford County, North Carolina",66741,66928,62899,56918,53787,12954,379
37163,"Sampson County, North Carolina",63284,62832,60161,47297,49687,13597,379
37165,"Scotland County, North Carolina",34921,36325,35998,33754,32273,2648,379
37167,"Stanly County, North Carolina",62050,60109,58100,51765,48517,13533,371
37169,"Stokes County, North Carolina",45688,47194,44711,37223,33086,12602,372
37171,"Surry County, North Carolina",71904,73287,71219,61704,59449,12455,372
37173,"Swain County, North Carolina",14241,13861,12968,11268,10283,3958,379
37175,"Transylvania County, North Carolina",34039,32404,29334,25520,23417,10622,379
37177,"Tyrrell County, North Carolina",3978,4374,4149,3856,3975,3,379
37179,"Union County, North Carolina",235767,190346,123677,84211,70380,165387,371
37181,"Vance County, North Carolina",44614,44975,42954,38892,36748,7866,379
37183,"Wake County, North Carolina",1091662,850546,627846,423380,301327,790335,373
37185,"Warren County, North Carolina",19746,20810,19972,17265,16232,3514,379
37187,"Washington County, North Carolina",11788,13248,13723,13997,14801,-3013,379
37189,"Watauga County, North Carolina",55669,49705,42695,36952,31666,24003,379
37191,"Wayne County, North Carolina",123785,120102,113329,104666,97054,26731,379
37193,"Wilkes County, North Carolina",68341,69063,65632,59393,58657,9684,379
37195,"Wilson County, North Carolina",81579,79533,73814,66061,63132,18447,379
37197,"Yadkin County, North Carolina",37589,38158,36348,30488,28439,9150,372
37199,"Yancey County, North Carolina",17870,17911,17774,15419,14934,2936,379
38001,"Adams County, North Dakota",2271,2348,2593,3174,3584,-1313,380
38003,"Barnes County, North Dakota",10592,11056,11775,12545,13960,-3368,380
38005,"Benson County, North Dakota",6860,6662,6964,7198,7944,-1084,380
38007,"Billings County, North Dakota",886,897,888,1108,1138,-252,380
38009,"Bottineau County, North Dakota",6418,6430,7149,8011,9239,-2821,380
38011,"Bowman County, North Dakota",3091,3102,3242,3596,4229,-1138,380
38013,"Burke County, North Dakota",2142,1948,2242,3002,3822,-1680,380
38015,"Burleigh County, North Dakota",95509,78776,69416,60131,54811,40698,380
38017,"Cass County, North Dakota",179937,144410,123138,102874,88247,91690,380
38019,"Cavalier County, North Dakota",3769,4046,4831,6064,7636,-3867,380
38021,"Dickey County, North Dakota",4857,5340,5757,6107,7207,-2350,380
38023,"Divide County, North Dakota",2289,2050,2283,2899,3494,-1205,380
38025,"Dunn County, North Dakota",4362,3477,3600,4005,4627,-265,380
38027,"Eddy County, North Dakota",2262,2455,2757,2951,3554,-1292,380
38029,"Emmons County, North Dakota",3262,3617,4331,4830,5877,-2615,380
38031,"Foster County, North Dakota",3231,3434,3759,3983,4611,-1380,380
38033,"Golden Valley County, North Dakota",1796,1539,1924,2108,2391,-595,380
38035,"Grand Forks County, North Dakota",70243,66771,66109,70683,66100,4143,380
38037,"Grant County, North Dakota",2318,2486,2841,3549,4274,-1956,380
38039,"Griggs County, North Dakota",2314,2426,2754,3303,3714,-1400,380
38041,"Hettinger County, North Dakota",2510,2506,2715,3445,4275,-1765,380
38043,"Kidder County, North Dakota",2468,2521,2753,3332,3833,-1365,380
38045,"La Moure County, North Dakota",4225,4233,4701,5383,6473,-2248,380
38047,"Logan County, North Dakota",1743,2001,2308,2847,3493,-1750,380
38049,"Mchenry County, North Dakota",5825,5400,5987,6528,7858,-2033,380
38051,"Mcintosh County, North Dakota",2535,2917,3390,4021,4800,-2265,380
38053,"Mckenzie County, North Dakota",13836,6004,5737,6383,7132,6704,380
38055,"Mclean County, North Dakota",9531,8861,9311,10457,12383,-2852,380
38057,"Mercer County, North Dakota",8359,8353,8644,9808,9404,-1045,380
38059,"Morton County, North Dakota",31118,26712,25303,23700,25177,5941,380
38061,"Mountrail County, North Dakota",10348,7228,6631,7021,7679,2669,380
38063,"Nelson County, North Dakota",2864,3185,3715,4410,5233,-2369,380
38065,"Oliver County, North Dakota",1962,1808,2065,2381,2495,-533,380
38067,"Pembina County, North Dakota",6850,7530,8585,9238,10399,-3549,380
38069,"Pierce County, North Dakota",4061,4364,4675,5052,6166,-2105,380
38071,"Ramsey County, North Dakota",11521,11371,12066,12681,13048,-1527,380
38073,"Ransom County, North Dakota",5258,5624,5890,5921,6698,-1440,380
38075,"Renville County, North Dakota",2387,2442,2610,3160,3608,-1221,380
38077,"Richland County, North Dakota",16245,16507,17998,18148,19207,-2962,380
38079,"Rolette County, North Dakota",14437,13766,13674,12772,12177,2260,380
38081,"Sargent County, North Dakota",3899,3971,4366,4549,5512,-1613,380
38083,"Sheridan County, North Dakota",1289,1293,1710,2148,2819,-1530,380
38085,"Sioux County, North Dakota",4339,4121,4044,3761,3620,719,380
38087,"Slope County, North Dakota",788,727,767,907,1157,-369,380
38089,"Stark County, North Dakota",31164,23486,22636,22832,23697,7467,380
38091,"Steele County, North Dakota",1817,1977,2258,2420,3106,-1289,380
38093,"Stutsman County, North Dakota",20879,20984,21908,22241,24154,-3275,380
38095,"Towner County, North Dakota",2191,2289,2876,3627,4052,-1861,380
38097,"Traill County, North Dakota",7999,8190,8477,8752,9624,-1625,380
38099,"Walsh County, North Dakota",10642,11286,12389,13840,15371,-4729,380
38101,"Ward County, North Dakota",68962,59461,58795,57921,58392,10570,380
38103,"Wells County, North Dakota",3889,4276,5102,5864,6979,-3090,380
38105,"Williams County, North Dakota",36044,21194,19761,21129,22237,13807,380
39001,"Adams County, Ohio",27685,28578,27330,25371,24328,3357,399
39003,"Allen County, Ohio",102808,106586,108473,109755,112241,-9433,399
39005,"Ashland County, Ohio",53533,53341,52523,47507,46178,7355,399
39007,"Ashtabula County, Ohio",97416,101867,102728,99821,104215,-6799,392
39009,"Athens County, Ohio",65945,64455,62223,59549,56399,9546,399
39011,"Auglaize County, Ohio",45709,46023,46611,44585,42554,3155,399
39013,"Belmont County, Ohio",67424,70403,70226,71074,82569,-15145,399
39015,"Brown County, Ohio",43508,44618,42285,34966,31920,11588,391
39017,"Butler County, Ohio",382129,363465,332807,291479,258787,123342,391
39019,"Carroll County, Ohio",27195,28988,28836,26521,25598,1597,399
39021,"Champaign County, Ohio",38861,40140,38890,36019,33649,5212,394
39023,"Clark County, Ohio",134409,139374,144742,147548,150236,-15827,394
39025,"Clermont County, Ohio",205616,195312,177977,150187,128483,77133,391
39027,"Clinton County, Ohio",42000,42416,40543,35415,34603,7397,391
39029,"Columbiana County, Ohio",102514,108609,112075,108276,113572,-11058,399
39031,"Coshocton County, Ohio",36558,37046,36655,35427,36024,534,399
39033,"Crawford County, Ohio",41603,44294,46966,47870,50075,-8472,399
39035,"Cuyahoga County, Ohio",1241475,1293825,1393978,1412140,1498400,-256925,392
39037,"Darke County, Ohio",51387,52945,53309,53619,55096,-3709,394
39039,"Defiance County, Ohio",38024,39119,39500,39350,39987,-1963,399
39041,"Delaware County, Ohio",205454,166108,109989,66929,53840,151614,393
39043,"Erie County, Ohio",74419,77454,79551,76779,79655,-5236,399
39045,"Fairfield County, Ohio",156204,143949,122759,103461,93678,62526,393
39047,"Fayette County, Ohio",28609,28913,28433,27466,27467,1142,393
39049,"Franklin County, Ohio",1304715,1141117,1068978,961437,869132,435583,393
39051,"Fulton County, Ohio",42186,42756,42084,38498,37751,4435,399
39053,"Gallia County, Ohio",29995,30943,31069,30954,30098,-103,399
39055,"Geauga County, Ohio",93657,93604,90895,81129,74474,19183,392
39057,"Greene County, Ohio",167867,159940,147886,136731,129769,38098,394
39059,"Guernsey County, Ohio",38996,40351,40792,39024,42024,-3028,399
39061,"Hamilton County, Ohio",815790,802194,845303,866228,873224,-57434,391
39063,"Hancock County, Ohio",75765,74670,71295,65536,64581,11184,399
39065,"Hardin County, Ohio",31393,32104,31945,31111,32719,-1326,399
39067,"Harrison County, Ohio",15132,15867,15856,16085,18152,-3020,399
39069,"Henry County, Ohio",27068,28546,29210,29108,28383,-1315,399
39071,"Highland County, Ohio",43080,43648,40875,35728,33477,9603,399
39073,"Hocking County, Ohio",28306,29338,28241,25533,24304,4002,399
39075,"Holmes County, Ohio",43954,42068,38943,32849,29416,14538,399
39077,"Huron County, Ohio",58271,59932,59487,56240,54608,3663,399
39079,"Jackson County, Ohio",32440,33165,32641,30230,30592,1848,399
39081,"Jefferson County, Ohio",65943,70041,73894,80298,91564,-25621,399
39083,"Knox County, Ohio",61776,60201,54500,47473,46304,15472,393
39085,"Lake County, Ohio",229755,229418,227511,215499,212801,16954,392
39087,"Lawrence County, Ohio",59901,62647,62319,61834,63849,-3948,399
39089,"Licking County, Ohio",175409,163708,145491,128300,120981,54428,393
39091,"Logan County, Ohio",45315,46006,46005,42310,39155,6160,399
39093,"Lorain County, Ohio",309134,299605,284664,271126,274909,34225,392
39095,"Lucas County, Ohio",430319,444046,455054,462361,471741,-41422,399
39097,"Madison County, Ohio",44248,42844,40213,37068,33004,11244,393
39099,"Mahoning County, Ohio",228452,241899,257555,264806,289487,-61035,399
39101,"Marion County, Ohio",65179,66530,66217,64274,67974,-2795,393
39103,"Medina County, Ohio",179116,170137,151095,122354,113150,65966,392
39105,"Meigs County, Ohio",22974,23649,23072,22987,23641,-667,399
39107,"Mercer County, Ohio",41034,40958,40924,39443,38334,2700,399
39109,"Miami County, Ohio",106074,102315,98868,93182,90381,15693,394
39111,"Monroe County, Ohio",13827,14751,15180,15497,17382,-3555,399
39113,"Montgomery County, Ohio",531988,538461,559062,573809,571697,-39709,394
39115,"Morgan County, Ohio",14557,15113,14897,14194,14241,316,399
39117,"Morrow County, Ohio",35148,34815,31628,27749,26480,8668,393
39119,"Muskingum County, Ohio",86033,85951,84585,82068,83340,2693,399
39121,"Noble County, Ohio",14410,14634,14058,11336,11310,3100,399
39123,"Ottawa County, Ohio",40557,41553,40985,40029,40076,481,399
39125,"Paulding County, Ohio",18742,19679,20293,20488,21302,-2560,399
39127,"Perry County, Ohio",36076,35843,34078,31557,31032,5044,399
39129,"Pickaway County, Ohio",58112,55128,52727,48255,43662,14450,393
39131,"Pike County, Ohio",27914,28674,27695,24249,22802,5112,399
39133,"Portage County, Ohio",162476,159943,152061,142585,135856,26620,392
39135,"Preble County, Ohio",40995,42502,42337,40113,38223,2772,399
39137,"Putnam County, Ohio",33836,34647,34726,33819,32991,845,399
39139,"Richland County, Ohio",121043,125980,128852,126137,131205,-10162,399
39141,"Ross County, Ohio",76816,77537,73345,69330,65004,11812,393
39143,"Sandusky County, Ohio",58801,61284,61792,61963,63267,-4466,399
39145,"Scioto County, Ohio",75441,78988,79195,80327,84545,-9104,399
39147,"Seneca County, Ohio",55251,57091,58683,59733,61901,-6650,399
39149,"Shelby County, Ohio",48610,49350,47910,44915,43089,5521,399
39151,"Stark County, Ohio",371516,376346,378098,367585,378823,-7307,399
39153,"Summit County, Ohio",540810,543150,542899,514990,524472,16338,392
39155,"Trumbull County, Ohio",199144,212780,225116,227813,241863,-42719,399
39157,"Tuscarawas County, Ohio",92165,92508,90914,84090,84614,7551,399
39159,"Union County, Ohio",57871,50708,40909,31969,29536,28335,393
39161,"Van Wert County, Ohio",28213,29029,29659,30464,30458,-2245,399
39163,"Vinton County, Ohio",13045,13485,12806,11098,11584,1461,399
39165,"Warren County, Ohio",232540,207790,158383,113909,99276,133264,391
39167,"Washington County, Ohio",60217,62066,63251,62254,64266,-4049,399
39169,"Wayne County, Ohio",116063,114438,111564,101461,97408,18655,399
39171,"Williams County, Ohio",36760,38172,39188,36956,36369,391,399
39173,"Wood County, Ohio",130662,125295,121065,113269,107372,23290,399
39175,"Wyandot County, Ohio",21907,22665,22908,22254,22651,-744,399
40001,"Adair County, Oklahoma",22171,22424,21038,18421,18575,3596,409
40003,"Alfalfa County, Oklahoma",5791,5621,6105,6416,7077,-1286,409
40005,"Atoka County, Oklahoma",13815,14140,13879,12778,12748,1067,409
40007,"Beaver County, Oklahoma",5326,5564,5857,6023,6806,-1480,409
40009,"Beckham County, Oklahoma",21860,21817,19799,18812,19243,2617,409
40011,"Blaine County, Oklahoma",9521,11972,11976,11470,13443,-3922,409
40013,"Bryan County, Oklahoma",47325,41195,36534,32089,30535,16790,409
40015,"Caddo County, Oklahoma",29179,28951,30150,29550,30905,-1726,409
40017,"Canadian County, Oklahoma",144610,109814,87697,74409,56452,88158,401
40019,"Carter County, Oklahoma",48380,46993,45621,42919,43610,4770,409
40021,"Cherokee County, Oklahoma",48871,46182,42521,34049,30684,18187,409
40023,"Choctaw County, Oklahoma",14727,15190,15342,15302,17203,-2476,409
40025,"Cimarron County, Oklahoma",2159,2503,3148,3301,3648,-1489,409
40027,"Cleveland County, Oklahoma",282189,246831,208016,174253,133173,149016,401
40029,"Coal County, Oklahoma",5577,5801,6031,5780,6041,-464,409
40031,"Comanche County, Oklahoma",121374,119902,114996,111486,112456,8918,409
40033,"Cotton County, Oklahoma",5783,6230,6614,6651,7338,-1555,409
40035,"Craig County, Oklahoma",14274,14951,14950,14104,15014,-740,409
40037,"Creek County, Oklahoma",71505,68914,67367,60915,59016,12489,402
40039,"Custer County, Oklahoma",28929,26824,26142,26897,25995,2934,409
40041,"Delaware County, Oklahoma",42741,41017,37077,28070,23946,18795,409
40043,"Dewey County, Oklahoma",4885,4720,4743,5551,5922,-1037,409
40045,"Ellis County, Oklahoma",3936,4041,4075,4497,5596,-1660,409
40047,"Garfield County, Oklahoma",61555,59093,57813,56735,62820,-1265,409
40049,"Garvin County, Oklahoma",27789,27462,27210,26605,27856,-67,409
40051,"Grady County, Oklahoma",55315,51545,45516,41747,39490,15825,401
40053,"Grant County, Oklahoma",4369,4579,5144,5689,6518,-2149,409
40055,"Greer County, Oklahoma",5790,6182,6061,6559,7028,-1238,409
40057,"Harmon County, Oklahoma",2663,2875,3283,3793,4519,-1856,409
40059,"Harper County, Oklahoma",3730,3607,3562,4063,4715,-985,409
40061,"Haskell County, Oklahoma",12688,12577,11792,10940,11010,1678,409
40063,"Hughes County, Oklahoma",13265,13606,14154,13023,14338,-1073,409
40065,"Jackson County, Oklahoma",24808,26386,28439,28764,30356,-5548,409
40067,"Jefferson County, Oklahoma",6084,6435,6818,7010,8183,-2099,409
40069,"Johnston County, Oklahoma",11028,10816,10513,10032,10356,672,409
40071,"Kay County, Oklahoma",44074,46473,48080,48056,49852,-5778,409
40073,"Kingfisher County, Oklahoma",15811,14776,13926,13212,14187,1624,409
40075,"Kiowa County, Oklahoma",8816,9540,10227,11347,12711,-3895,409
40077,"Latimer County, Oklahoma",10239,11015,10692,10333,9840,399,409
40079,"Le Flore County, Oklahoma",49999,49822,48109,43270,40698,9301,409
40081,"Lincoln County, Oklahoma",34936,33823,32080,29216,26601,8335,401
40083,"Logan County, Oklahoma",47401,39777,33924,29011,26881,20520,401
40085,"Love County, Oklahoma",10128,9306,8831,8157,7469,2659,409
40087,"Mcclain County, Oklahoma",39921,33107,27740,22795,20291,19630,401
40089,"Mccurtain County, Oklahoma",32913,33130,34402,33433,36151,-3238,409
40091,"Mcintosh County, Oklahoma",19677,20012,19456,16779,15562,4115,409
40093,"Major County, Oklahoma",7654,7487,7545,8055,8772,-1118,409
40095,"Marshall County, Oklahoma",16688,15465,13184,10829,10550,6138,409
40097,"Mayes County, Oklahoma",41098,40807,38369,33366,32261,8837,409
40099,"Murray County, Oklahoma",13972,13193,12623,12042,12147,1825,409
40101,"Muskogee County, Oklahoma",68451,70383,69451,68078,66939,1512,409
40103,"Noble County, Oklahoma",11263,11509,11411,11045,11573,-310,409
40105,"Nowata County, Oklahoma",10243,10674,10569,9992,11486,-1243,409
40107,"Okfuskee County, Oklahoma",11987,12036,11814,11551,11125,862,409
40109,"Oklahoma County, Oklahoma",792668,704023,660448,599611,568933,223735,401
40111,"Okmulgee County, Oklahoma",38553,39664,39685,36490,39169,-616,402
40113,"Osage County, Oklahoma",47074,47192,44437,41645,39327,7747,402
40115,"Ottawa County, Oklahoma",31283,32193,33194,30561,32870,-1587,409
40117,"Pawnee County, Oklahoma",16402,16564,16612,15575,15310,1092,402
40119,"Payne County, Oklahoma",81912,75687,68190,61507,62435,19477,409
40121,"Pittsburg County, Oklahoma",43955,45417,43953,40581,40524,3431,409
40123,"Pontotoc County, Oklahoma",38385,36644,35143,34119,32598,5787,409
40125,"Pottawatomie County, Oklahoma",72511,68751,65521,58760,55239,17272,401
40127,"Pushmataha County, Oklahoma",11055,11500,11667,10997,11773,-718,409
40129,"Roger Mills County, Oklahoma",3635,3530,3436,4147,4799,-1164,409
40131,"Rogers County, Oklahoma",92052,85044,70641,55170,46436,45616,402
40133,"Seminole County, Oklahoma",24624,25224,24894,25412,27473,-2849,409
40135,"Sequoyah County, Oklahoma",41687,41855,38972,33828,30749,10938,409
40137,"Stephens County, Oklahoma",43401,44454,43182,42299,43419,-18,409
40139,"Texas County, Oklahoma",20633,19826,20107,16419,17727,2906,409
40141,"Tillman County, Oklahoma",7347,8154,9287,10384,12398,-5051,409
40143,"Tulsa County, Oklahoma",650291,589757,563299,503341,470593,179698,402
40145,"Wagoner County, Oklahoma",80264,70232,57491,47883,41801,38463,402
40147,"Washington County, Oklahoma",51995,50339,48996,48066,48113,3882,402
40149,"Washita County, Oklahoma",11066,11571,11508,11441,13798,-2732,409
40151,"Woods County, Oklahoma",8914,8656,9089,9103,10923,-2009,409
40153,"Woodward County, Oklahoma",20352,19967,18486,18976,21172,-820,409
41001,"Baker County, Oregon",16090,16150,16741,15317,16134,-44,419
41003,"Benton County, Oregon",92168,84158,78153,70811,68211,23957,419
41005,"Clackamas County, Oregon",415084,370479,338391,278850,241919,173165,411
41007,"Clatsop County, Oregon",39656,36858,35630,33301,32489,7167,419
41009,"Columbia County, Oregon",52117,49006,43560,37557,35646,16471,411
41011,"Coos County, Oregon",64175,63319,62779,60273,64047,128,419
41013,"Crook County, Oregon",23733,21515,19182,14111,13091,10642,419
41015,"Curry County, Oregon",22889,22411,21137,19327,16992,5897,419
41017,"Deschutes County, Oregon",191749,154568,115367,74958,62142,129607,419
41019,"Douglas County, Oregon",110015,107209,100399,94649,93748,16267,419
41021,"Gilliam County, Oregon",1896,1731,1915,1717,2057,-161,419
41023,"Grant County, Oregon",7174,7349,7935,7853,8210,-1036,419
41025,"Harney County, Oregon",7310,7364,7609,7060,8314,-1004,419
41027,"Hood River County, Oregon",23270,21706,20411,16903,15835,7435,419
41029,"Jackson County, Oregon",218781,200587,181269,146389,132456,86325,419
41031,"Jefferson County, Oregon",24048,21652,19009,13676,11599,12449,419
41033,"Josephine County, Oregon",87097,82172,75726,62649,58855,28242,419
41035,"Klamath County, Oregon",67606,66520,63775,57702,59117,8489,419
41037,"Lake County, Oregon",7896,7882,7422,7186,7532,364,419
41039,"Lane County, Oregon",377749,347156,322959,282912,275226,102523,419
41041,"Lincoln County, Oregon",49336,45857,44479,38889,35264,14072,419
41043,"Linn County, Oregon",127216,114315,103069,91227,89495,37721,419
41045,"Malheur County, Oregon",30632,31326,31615,26038,26896,3736,419
41047,"Marion County, Oregon",343742,309894,284834,228483,204692,139050,419
41049,"Morrow County, Oregon",11425,11112,10995,7625,7519,3906,419
41051,"Multnomah County, Oregon",809869,712036,660486,583887,562640,247229,411
41053,"Polk County, Oregon",84730,73745,62380,49541,45203,39527,419
41055,"Sherman County, Oregon",1686,1819,1934,1918,2172,-486,419
41057,"Tillamook County, Oregon",26782,25200,24262,21570,21164,5618,419
41059,"Umatilla County, Oregon",77319,74804,70548,59249,58861,18458,419
41061,"Union County, Oregon",26502,25373,24530,23598,23921,2581,419
41063,"Wallowa County, Oregon",7065,6919,7226,6911,7273,-208,419
41065,"Wasco County, Oregon",26274,24695,23791,21683,21732,4542,419
41067,"Washington County, Oregon",595761,516665,445342,311554,245808,349953,411
41069,"Wheeler County, Oregon",1417,1443,1547,1396,1513,-96,419
41071,"Yamhill County, Oregon",106087,96930,84992,65551,55332,50755,411
42001,"Adams County, Pennsylvania",102627,100839,91292,78274,68292,34335,429
42003,"Allegheny County, Pennsylvania",1218380,1223066,1281666,1336449,1450085,-231705,422
42005,"Armstrong County, Pennsylvania",65356,69489,72392,73478,77768,-12412,422
42007,"Beaver County, Pennsylvania",164781,171569,181412,186093,204441,-39660,422
42009,"Bedford County, Pennsylvania",48154,49882,49984,47919,46784,1370,429
42011,"Berks County, Pennsylvania",419062,407310,373638,336523,312509,106553,421
42013,"Blair County, Pennsylvania",122495,127071,129144,130542,136621,-14126,429
42015,"Bradford County, Pennsylvania",60721,62415,62761,60967,62919,-2198,429
42017,"Bucks County, Pennsylvania",627668,622859,597635,541174,479211,148457,421
42019,"Butler County, Pennsylvania",187798,182554,174083,152013,147912,39886,422
42021,"Cambria County, Pennsylvania",131611,144741,152598,163029,183263,-51652,429
42023,"Cameron County, Pennsylvania",4512,5197,5974,5913,6674,-2162,429
42025,"Carbon County, Pennsylvania",63964,64563,58802,56846,53285,10679,429
42027,"Centre County, Pennsylvania",162264,151411,135758,123786,112760,49504,429
42029,"Chester County, Pennsylvania",521980,490571,433501,376396,316660,205320,421
42031,"Clarion County, Pennsylvania",38633,40290,41765,41699,43362,-4729,429
42033,"Clearfield County, Pennsylvania",79466,82131,83382,78097,83578,-4112,429
42035,"Clinton County, Pennsylvania",38549,38970,37914,37182,38971,-422,429
42037,"Columbia County, Pennsylvania",65390,66642,64151,63202,61967,3423,429
42039,"Crawford County, Pennsylvania",85074,89153,90366,86169,88869,-3795,429
42041,"Cumberland County, Pennsylvania",251487,231336,213674,195257,178541,72946,429
42043,"Dauphin County, Pennsylvania",277071,264823,251798,237813,232317,44754,429
42045,"Delaware County, Pennsylvania",565328,556468,550864,547651,555007,10321,421
42047,"Elk County, Pennsylvania",30077,32480,35112,34878,38338,-8261,429
42049,"Erie County, Pennsylvania",272046,279234,280843,275572,279780,-7734,429
42051,"Fayette County, Pennsylvania",130329,138807,148644,145351,159417,-29088,422
42053,"Forest County, Pennsylvania",7190,7585,4946,4802,5072,2118,429
42055,"Franklin County, Pennsylvania",154954,146558,129313,121082,113629,41325,429
42057,"Fulton County, Pennsylvania",14492,14839,14261,13837,12842,1650,429
42059,"Greene County, Pennsylvania",36484,39003,40672,39550,40476,-3992,429
42061,"Huntingdon County, Pennsylvania",45145,45830,45586,44164,42253,2892,429
42063,"Indiana County, Pennsylvania",84463,88745,89605,89994,92281,-7818,429
42065,"Jefferson County, Pennsylvania",43570,45244,45932,46083,48303,-4733,429
42067,"Juniata County, Pennsylvania",24657,24385,22821,20625,19188,5469,429
42069,"Lackawanna County, Pennsylvania",210162,213731,213295,219039,227908,-17746,429
42071,"Lancaster County, Pennsylvania",543050,511250,470658,422822,362346,180704,429
42073,"Lawrence County, Pennsylvania",86148,91682,94643,96246,107150,-21002,422
42075,"Lebanon County, Pennsylvania",140410,131341,120327,113744,108582,31828,429
42077,"Lehigh County, Pennsylvania",367338,343946,312090,291130,272349,94989,429
42079,"Luzerne County, Pennsylvania",317547,319120,319250,328149,343079,-25532,429
42081,"Lycoming County, Pennsylvania",114014,116376,120044,118710,118416,-4402,429
42083,"Mckean County, Pennsylvania",41021,43853,45936,47131,50635,-9614,429
42085,"Mercer County, Pennsylvania",110519,117296,120293,121003,128299,-17780,429
42087,"Mifflin County, Pennsylvania",46179,46583,46486,46197,46908,-729,429
42089,"Monroe County, Pennsylvania",168824,168080,138687,95709,69409,99415,429
42091,"Montgomery County, Pennsylvania",827180,790497,750097,678111,643621,183559,421
42093,"Montour County, Pennsylvania",18178,18152,18236,17735,16675,1503,429
42095,"Northampton County, Pennsylvania",304233,294536,267066,247105,225418,78815,429
42097,"Northumberland County, Pennsylvania",91234,94099,94556,96771,100381,-9147,429
42099,"Perry County, Pennsylvania",46133,45599,43602,41172,35718,10415,429
42101,"Philadelphia County, Pennsylvania",1581531,1504950,1517550,1585577,1688210,-106679,421
42103,"Pike County, Pennsylvania",55660,56993,46302,27966,18271,37389,429
42105,"Potter County, Pennsylvania",16685,17583,18080,16717,17726,-1041,429
42107,"Schuylkill County, Pennsylvania",141935,148288,150336,152585,160630,-18695,429
42109,"Snyder County, Pennsylvania",40452,39400,37546,36680,33584,6868,429
42111,"Somerset County, Pennsylvania",73844,78219,80023,78218,81243,-7399,429
42113,"Sullivan County, Pennsylvania",6038,6467,6556,6104,6349,-311,429
42115,"Susquehanna County, Pennsylvania",40604,43343,42238,40380,37876,2728,429
42117,"Tioga County, Pennsylvania",40759,41631,41373,41126,40973,-214,429
42119,"Union County, Pennsylvania",44831,44866,41624,36176,32870,11961,429
42121,"Venango County, Pennsylvania",51355,55320,57565,59381,64444,-13089,429
42123,"Warren County, Pennsylvania",39466,41877,43863,45050,47449,-7983,429
42125,"Washington County, Pennsylvania",207081,206987,202897,204584,217074,-9993,422
42127,"Wayne County, Pennsylvania",51268,52302,47722,39944,35237,16031,429
42129,"Westmoreland County, Pennsylvania",350722,365841,369993,370321,392294,-41572,422
42131,"Wyoming County, Pennsylvania",27078,28262,28080,28076,26433,645,429
42133,"York County, Pennsylvania",447628,428175,381751,339574,312963,134665,429
44001,"Bristol County, Rhode Island",48645,50501,50648,48859,46942,1703,441
44003,"Kent County, Rhode Island",164122,167235,167090,161135,154163,9959,441
44005,"Newport County, Rhode Island",82731,83253,85433,87194,81383,1348,441
44007,"Providence County, Rhode Island",636161,628413,621602,596270,571349,64812,441
44009,"Washington County, Rhode Island",126139,126987,123546,110006,93317,32822,441
45001,"Abbeville County, South Carolina",24582,25643,26167,23862,22627,1955,459
45003,"Aiken County, South Carolina",169947,156670,142552,120940,105625,64322,459
45005,"Allendale County, South Carolina",8789,10688,11211,11722,10700,-1911,459
45007,"Anderson County, South Carolina",200183,183691,165740,145196,133235,66948,452
45009,"Bamberg County, South Carolina",14236,16139,16658,16902,18118,-3882,459
45011,"Barnwell County, South Carolina",21170,22748,23478,20293,19868,1302,459
45013,"Beaufort County, South Carolina",189732,155550,120937,86425,65364,124368,459
45015,"Berkeley County, South Carolina",222103,169878,142651,128776,94727,127376,451
45017,"Calhoun County, South Carolina",14608,15212,15185,12753,12206,2402,459
45019,"Charleston County, South Carolina",407543,342434,309969,295039,276974,130569,451
45021,"Cherokee County, South Carolina",57110,54832,52537,44506,40983,16127,452
45023,"Chester County, South Carolina",32260,33246,34068,32170,30148,2112,459
45025,"Chesterfield County, South Carolina",45833,46087,42768,38577,38161,7672,459
45027,"Clarendon County, South Carolina",33865,34621,32502,28450,27464,6401,459
45029,"Colleton County, South Carolina",37624,38833,38264,34377,31776,5848,459
45031,"Darlington County, South Carolina",66858,68602,67394,61851,62717,4141,459
45033,"Dillon County, South Carolina",30473,31666,30722,29114,31083,-610,459
45035,"Dorchester County, South Carolina",161309,129618,96413,83060,58761,102548,451
45037,"Edgefield County, South Carolina",27021,26680,24595,18375,17528,9493,459
45039,"Fairfield County, South Carolina",22406,24040,23454,22295,20700,1706,459
45041,"Florence County, South Carolina",138237,134897,125761,114344,110163,28074,459
45043,"Georgetown County, South Carolina",62150,60236,55797,46302,42461,19689,459
45045,"Greenville County, South Carolina",516126,436437,379616,320167,287913,228213,452
45047,"Greenwood County, South Carolina",70672,68890,66271,59567,57847,12825,459
45049,"Hampton County, South Carolina",19223,21173,21386,18191,18159,1064,459
45051,"Horry County, South Carolina",344186,258267,196629,144053,101419,242767,459
45053,"Jasper County, South Carolina",29558,23634,20678,15487,14504,15054,459
45055,"Kershaw County, South Carolina",65926,60166,52647,43599,39015,26911,459
45057,"Lancaster County, South Carolina",95378,72302,61351,54516,53361,42017,459
45059,"Laurens County, South Carolina",66990,67026,69567,58092,52214,14776,452
45061,"Lee County, South Carolina",17144,19615,20119,18437,18929,-1785,459
45063,"Lexington County, South Carolina",295033,252563,216014,167611,140353,154680,459
45065,"Mccormick County, South Carolina",9495,10203,9958,8868,7797,1698,459
45067,"Marion County, South Carolina",30954,33568,35466,33899,34179,-3225,459
45069,"Marlboro County, South Carolina",26376,29112,28818,29361,31634,-5258,459
45071,"Newberry County, South Carolina",38329,37197,36108,33172,31242,7087,459
45073,"Oconee County, South Carolina",78314,73035,66215,57494,48611,29703,452
45075,"Orangeburg County, South Carolina",86953,92475,91582,84803,82276,4677,459
45077,"Pickens County, South Carolina",125381,117823,110757,93894,79292,46089,452
45079,"Richland County, South Carolina",414660,372597,320677,285720,269735,144925,459
45081,"Saluda County, South Carolina",20292,19567,19181,16357,16150,4142,459
45083,"Spartanburg County, South Carolina",313791,278167,253791,226800,201861,111930,452
45085,"Sumter County, South Carolina",106675,106601,104646,102637,88243,18432,459
45087,"Union County, South Carolina",27325,29089,29881,30337,30751,-3426,452
45089,"Williamsburg County, South Carolina",30810,34994,37217,36815,38226,-7416,459
45091,"York County, South Carolina",273887,214916,164614,131497,106720,167167,459
46003,"Aurora County, South Dakota",2757,2739,3058,3135,3628,-871,460
46005,"Beadle County, South Dakota",18338,16829,17023,18253,19195,-857,460
46007,"Bennett County, South Dakota",3430,3441,3574,3206,3044,386,460
46009,"Bon Homme County, South Dakota",6914,7080,7260,7089,8059,-1145,460
46011,"Brookings County, South Dakota",35115,31250,28220,25207,24332,10783,460
46013,"Brown County, South Dakota",38988,36011,35460,35580,36962,2026,460
46015,"Brule County, South Dakota",5233,5128,5364,5485,5245,-12,460
46017,"Buffalo County, South Dakota",2005,1932,2032,1759,1795,210,460
46019,"Butte County, South Dakota",10295,9888,9094,7914,8372,1923,460
46021,"Campbell County, South Dakota",1458,1431,1782,1965,2243,-785,460
46023,"Charles Mix County, South Dakota",9324,9075,9350,9131,9680,-356,460
46025,"Clark County, South Dakota",3715,3702,4143,4403,4894,-1179,460
46027,"Clay County, South Dakota",14076,13816,13537,13186,13689,387,460
46029,"Codington County, South Dakota",28133,27040,25897,22698,20885,7248,460
46031,"Corson County, South Dakota",4106,4053,4181,4195,5196,-1090,460
46033,"Custer County, South Dakota",8826,8085,7275,6179,6000,2826,460
46035,"Davison County, South Dakota",19890,19397,18741,17503,17820,2070,460
46037,"Day County, South Dakota",5452,5714,6267,6978,8133,-2681,460
46039,"Deuel County, South Dakota",4309,4373,4498,4522,5289,-980,460
46041,"Dewey County, South Dakota",5841,5354,5972,5523,5366,475,460
46043,"Douglas County, South Dakota",2913,3046,3458,3746,4181,-1268,460
46045,"Edmunds County, South Dakota",3876,4047,4367,4356,5159,-1283,460
46047,"Fall River County, South Dakota",6721,7078,7453,7353,8439,-1718,460
46049,"Faulk County, South Dakota",2315,2386,2640,2744,3327,-1012,460
46051,"Grant County, South Dakota",7125,7382,7847,8372,9013,-1888,460
46053,"Gregory County, South Dakota",4193,4272,4792,5359,6015,-1822,460
46055,"Haakon County, South Dakota",1935,1886,2196,2624,2794,-859,460
46057,"Hamlin County, South Dakota",6104,5761,5540,4974,5261,843,460
46059,"Hand County, South Dakota",3064,3402,3741,4272,4948,-1884,460
46061,"Hanson County, South Dakota",3423,3382,3139,2994,3415,8,460
46063,"Harding County, South Dakota",1178,1250,1353,1669,1700,-522,460
46065,"Hughes County, South Dakota",17560,16827,16481,14817,14220,3340,460
46067,"Hutchinson County, South Dakota",7308,7388,8075,8262,9350,-2042,460
46069,"Hyde County, South Dakota",1446,1520,1671,1696,2069,-623,460
46071,"Jackson County, South Dakota",3296,2991,2930,2811,3437,-141,460
46073,"Jerauld County, South Dakota",2009,2038,2295,2425,2929,-920,460
46075,"Jones County, South Dakota",873,1076,1193,1324,1463,-590,460
46077,"Kingsbury County, South Dakota",4936,5169,5815,5925,6679,-1743,460
46079,"Lake County, South Dakota",12747,11008,11276,10550,10724,2023,460
46081,"Lawrence County, South Dakota",25806,23670,21802,20655,18339,7467,460
46083,"Lincoln County, South Dakota",58887,41289,24131,15427,13942,44945,460
46085,"Lyman County, South Dakota",3831,3736,3895,3638,3864,-33,460
46087,"Mccook County, South Dakota",5543,5639,5832,5688,6444,-901,460
46089,"Mcpherson County, South Dakota",2316,2506,2904,3228,4027,-1711,460
46091,"Marshall County, South Dakota",4881,4618,4576,4844,5404,-523,460
46093,"Meade County, South Dakota",28149,25156,24253,21878,20717,7432,460
46095,"Mellette County, South Dakota",2065,2032,2083,2137,2249,-184,460
46097,"Miner County, South Dakota",2213,2411,2884,3272,3739,-1526,460
46099,"Minnehaha County, South Dakota",191682,165799,148281,123809,109435,82247,460
46101,"Moody County, South Dakota",6508,6511,6595,6507,6692,-184,460
46103,"Pennington County, South Dakota",112504,97922,88565,81343,70361,42143,460
46105,"Perkins County, South Dakota",2996,2976,3363,3932,4700,-1704,460
46107,"Potter County, South Dakota",2311,2380,2693,3190,3674,-1363,460
46109,"Roberts County, South Dakota",10310,10033,10016,9914,10911,-601,460
46111,"Sanborn County, South Dakota",2372,2380,2675,2833,3213,-841,460
46115,"Spink County, South Dakota",6438,6518,7454,7981,9201,-2763,460
46117,"Stanley County, South Dakota",3058,2896,2772,2453,2533,525,460
46119,"Sully County, South Dakota",1278,1328,1556,1589,1990,-712,460
46121,"Todd County, South Dakota",10308,9575,9050,8352,7328,2980,460
46123,"Tripp County, South Dakota",5448,5743,6430,6924,7268,-1820,460
46125,"Turner County, South Dakota",8325,8368,8849,8576,9255,-930,460
46127,"Union County, South Dakota",15659,13903,12584,10189,10938,4721,460
46129,"Walworth County, South Dakota",5431,5408,5974,6087,7011,-1580,460
46135,"Yankton County, South Dakota",22746,22216,21652,19252,18952,3794,460
46137,"Ziebach County, South Dakota",2767,2765,2519,2220,2308,459,460
47001,"Anderson County, Tennessee",76513,74257,71330,68250,67346,9167,479
47003,"Bedford County, Tennessee",48937,44172,37586,30411,27916,21021,479
47005,"Benton County, Tennessee",16133,16456,16537,14524,14901,1232,479
47007,"Bledsoe County, Tennessee",14961,12946,12367,9669,9478,5483,479
47009,"Blount County, Tennessee",131641,121140,105823,85969,77770,53871,479
47011,"Bradley County, Tennessee",106924,97192,87965,73712,67547,39377,479
47013,"Campbell County, Tennessee",39818,40623,39854,35079,34923,4895,479
47015,"Cannon County, Tennessee",14374,13631,12826,10467,10234,4140,472
47017,"Carroll County, Tennessee",27841,28644,29475,27514,28285,-444,479
47019,"Carter County, Tennessee",56452,57710,56742,51505,50205,6247,479
47021,"Cheatham County, Tennessee",40539,38809,35912,27140,21616,18923,472
47023,"Chester County, Tennessee",17260,16793,15540,12819,12727,4533,479
47025,"Claiborne County, Tennessee",31827,31901,29862,26137,24595,7232,479
47027,"Clay County, Tennessee",7640,7888,7976,7238,7676,-36,479
47029,"Cocke County, Tennessee",35797,35473,33565,29141,28792,7005,479
47031,"Coffee County, Tennessee",56024,52344,48014,40339,38311,17713,479
47033,"Crockett County, Tennessee",14310,14524,14532,13378,14941,-631,479
47035,"Cumberland County, Tennessee",60016,54977,46802,34736,28676,31340,479
47037,"Davidson County, Tennessee",690540,612884,569891,510784,477811,212729,472
47039,"Decatur County, Tennessee",11663,11716,11731,10472,10857,806,479
47041,"De Kalb County, Tennessee",20104,18569,17423,14360,13589,6515,479
47043,"Dickson County, Tennessee",53289,48712,43156,35061,30037,23252,472
47045,"Dyer County, Tennessee",37201,38174,37279,34854,34663,2538,479
47047,"Fayette County, Tennessee",40612,37458,28806,25559,25305,15307,471
47049,"Fentress County, Tennessee",18405,17777,16625,14669,14826,3579,479
47051,"Franklin County, Tennessee",41999,41054,39270,34725,31983,10016,479
47053,"Gibson County, Tennessee",49193,49015,48152,46315,49467,-274,479
47055,"Giles County, Tennessee",29403,29558,29447,25741,24625,4778,479
47057,"Grainger County, Tennessee",23268,22419,20659,17095,16751,6517,479
47059,"Greene County, Tennessee",69077,68172,62909,55853,54422,14655,479
47061,"Grundy County, Tennessee",13371,13910,14332,13362,13787,-416,479
47063,"Hamblen County, Tennessee",64479,61857,58128,50480,49300,15179,479
47065,"Hamilton County, Tennessee",364718,328960,307896,285536,287740,76978,479
47067,"Hancock County, Tennessee",6568,6782,6786,6739,6887,-319,479
47069,"Hardeman County, Tennessee",25247,27655,28105,23377,23873,1374,479
47071,"Hardin County, Tennessee",25665,25995,25578,22633,22280,3385,479
47073,"Hawkins County, Tennessee",56735,56562,53563,44565,43751,12984,479
47075,"Haywood County, Tennessee",17391,19010,19797,19437,20318,-2927,479
47077,"Henderson County, Tennessee",27956,27518,25522,21844,21390,6566,479
47079,"Henry County, Tennessee",32251,32042,31115,27888,28656,3595,479
47081,"Hickman County, Tennessee",25017,24506,22295,16754,15151,9866,472
47083,"Houston County, Tennessee",8201,8286,8088,7018,6871,1330,479
47085,"Humphreys County, Tennessee",18528,18416,17929,15795,15957,2571,479
47087,"Jackson County, Tennessee",11767,11491,10984,9297,9398,2369,479
47089,"Jefferson County, Tennessee",54162,50600,44294,33016,31284,22878,479
47091,"Johnson County, Tennessee",17755,18190,17499,13766,13745,4010,479
47093,"Knox County, Tennessee",466184,423748,382032,335749,319694,146490,479
47095,"Lake County, Tennessee",7273,7827,7954,7129,7455,-182,479
47097,"Lauderdale County, Tennessee",25689,27745,27101,23491,24555,1134,479
47099,"Lawrence County, Tennessee",43780,41319,39926,35303,34110,9670,479
47101,"Lewis County, Tennessee",12131,12003,11367,9247,9700,2431,479
47103,"Lincoln County, Tennessee",34158,32885,31340,28157,26483,7675,479
47105,"Loudon County, Tennessee",53169,47102,39086,31255,28553,24616,479
47107,"Mcminn County, Tennessee",53392,52075,49015,42383,41878,11514,479
47109,"Mcnairy County, Tennessee",25814,25760,24653,22422,22525,3289,479
47111,"Macon County, Tennessee",24208,21934,20386,15906,15700,8508,472
47113,"Madison County, Tennessee",97838,97378,91837,77982,74546,23292,479
47115,"Marion County, Tennessee",28639,28123,27776,24860,24416,4223,479
47117,"Marshall County, Tennessee",33708,29902,26767,21539,19698,14010,479
47119,"Maury County, Tennessee",94615,79029,69498,54812,51095,43520,472
47121,"Meigs County, Tennessee",12237,11581,11086,8033,7431,4806,479
47123,"Monroe County, Tennessee",46413,44015,38961,30541,28700,17713,479
47125,"Montgomery County, Tennessee",204992,163603,134768,100498,83342,121650,479
47127,"Moore County, Tennessee",6396,6266,5740,4721,4510,1886,479
47129,"Morgan County, Tennessee",21538,21664,19757,17300,16604,4934,479
47131,"Obion County, Tennessee",30343,31905,32450,31717,32781,-2438,479
47133,"Overton County, Tennessee",22171,21777,20118,17636,17575,4596,479
47135,"Perry County, Tennessee",8020,7778,7631,6612,6111,1909,479
47137,"Pickett County, Tennessee",5068,5072,4945,4548,4358,710,479
47139,"Polk County, Tennessee",16807,16690,16050,13643,13602,3205,479
47141,"Putnam County, Tennessee",78542,70570,62315,51373,47690,30852,479
47143,"Rhea County, Tennessee",32964,31215,28400,24344,24235,8729,479
47145,"Roane County, Tennessee",53331,54156,51910,47227,48425,4906,479
47147,"Robertson County, Tennessee",70982,64347,54433,41494,37021,33961,472
47149,"Rutherford County, Tennessee",324139,250517,182023,118570,84058,240081,472
47151,"Scott County, Tennessee",22020,22171,21127,18358,19259,2761,479
47153,"Sequatchie County, Tennessee",14936,13814,11370,8863,8605,6331,479
47155,"Sevier County, Tennessee",98007,87507,71170,51043,41418,56589,479
47157,"Shelby County, Tennessee",936611,922696,897472,826330,777113,159498,471
47159,"Smith County, Tennessee",19926,19035,17712,14143,14935,4991,472
47161,"Stewart County, Tennessee",13553,13133,12370,9479,8665,4888,479
47163,"Sullivan County, Tennessee",157707,155815,153048,143596,143968,13739,479
47165,"Sumner County, Tennessee",187680,155592,130449,103281,85790,101890,472
47167,"Tipton County, Tennessee",61562,59689,51271,37568,32930,28632,471
47169,"Trousdale County, Tennessee",10910,7751,7259,5920,6137,4773,472
47171,"Unicoi County, Tennessee",17821,18257,17667,16549,16362,1459,479
47173,"Union County, Tennessee",19678,19088,17808,13694,11707,7971,479
47175,"Van Buren County, Tennessee",5813,5503,5508,4846,4728,1085,479
47177,"Warren County, Tennessee",40971,39539,38276,32992,32653,8318,479
47179,"Washington County, Tennessee",128874,119768,107198,92315,88755,40119,479
47181,"Wayne County, Tennessee",16638,17016,16842,13935,13946,2692,479
47183,"Weakley County, Tennessee",33377,34557,34895,31972,32896,481,479
47185,"White County, Tennessee",27087,25460,23102,20090,19567,7520,479
47187,"Williamson County, Tennessee",232380,174260,126638,81021,58108,174272,472
47189,"Wilson County, Tennessee",140604,109563,88809,67675,56064,84540,472
48001,"Anderson County, Texas",57917,58016,55109,48024,38381,19536,489
48003,"Andrews County, Texas",18227,14048,13004,14338,13323,4904,489
48005,"Angelina County, Texas",87119,85254,80130,69884,64172,22947,489
48007,"Aransas County, Texas",24220,23247,22497,17892,14260,9960,483
48009,"Archer County, Texas",8754,9055,8854,7973,7266,1488,489
48011,"Armstrong County, Texas",1950,1958,2148,2021,1994,-44,489
48013,"Atascosa County, Texas",50194,44049,38628,30533,25055,25139,488
48015,"Austin County, Texas",29892,27783,23590,19832,17726,12166,486
48017,"Bailey County, Texas",6916,7027,6594,7064,8168,-1252,489
48019,"Bandera County, Texas",22770,20265,17645,10562,7084,15686,488
48021,"Bastrop County, Texas",86839,72289,57733,38263,24726,62113,481
48023,"Baylor County, Texas",3560,3795,4093,4385,4919,-1359,489
48025,"Bee County, Texas",32609,31896,32359,25135,26030,6579,489
48027,"Bell County, Texas",355700,294689,237974,191088,157889,197811,489
48029,"Bexar County, Texas",1978826,1650052,1392931,1185394,988800,990026,488
48031,"Blanco County, Texas",11733,10085,8418,5972,4681,7052,489
48033,"Borden County, Texas",653,564,729,799,859,-206,489
48035,"Bosque County, Texas",18428,18067,17204,15125,13401,5027,489
48037,"Bowie County, Texas",93622,91399,89306,81665,75301,18321,489
48039,"Brazoria County, Texas",368062,300522,241767,191707,169587,198475,486
48041,"Brazos County, Texas",226370,185426,152415,121862,93588,132782,489
48043,"Brewster County, Texas",9231,8971,8866,8681,7573,1658,489
48045,"Briscoe County, Texas",1348,1723,1790,1971,2579,-1231,489
48047,"Brooks County, Texas",7100,7349,7976,8204,8428,-1328,489
48049,"Brown County, Texas",37805,38199,37674,34371,33057,4748,489
48051,"Burleson County, Texas",18237,17058,16470,13625,12313,5924,489
48053,"Burnet County, Texas",47548,42215,34147,22677,17803,29745,489
48055,"Caldwell County, Texas",42817,37416,32194,26392,23637,19180,481
48057,"Calhoun County, Texas",21470,21120,20647,19053,19574,1896,489
48059,"Callahan County, Texas",13959,13458,12905,11859,10992,2967,489
48061,"Cameron County, Texas",422135,393566,335227,260120,209727,212408,489
48063,"Camp County, Texas",12938,12288,11549,9904,9275,3663,489
48065,"Carson County, Texas",5957,6284,6516,6576,6672,-715,489
48067,"Cass County, Texas",30002,30254,30438,29982,29430,572,489
48069,"Castro County, Texas",7561,7848,8285,9070,10556,-2995,489
48071,"Chambers County, Texas",42571,32371,26031,20088,18538,24033,486
48073,"Cherokee County, Texas",52341,50035,46659,41049,38127,14214,489
48075,"Childress County, Texas",7219,7115,7688,5953,6950,269,489
48077,"Clay County, Texas",10444,10922,11006,10024,9582,862,489
48079,"Cochran County, Texas",2860,3155,3730,4377,4825,-1965,489
48081,"Coke County, Texas",3298,3301,3864,3424,3196,102,489
48083,"Coleman County, Texas",8281,8857,9235,9710,10439,-2158,489
48085,"Collin County, Texas",1006038,738745,491675,264036,144576,861462,484
48087,"Collingsworth County, Texas",2939,3009,3206,3573,4648,-1709,489
48089,"Colorado County, Texas",21357,20751,20390,18383,18823,2534,489
48091,"Comal County, Texas",148921,102836,78021,51832,36446,112475,488
48093,"Comanche County, Texas",13597,13863,14026,13381,12617,980,489
48095,"Concho County, Texas",3018,4047,3966,3044,2915,103,489
48097,"Cooke County, Texas",40428,38316,36363,30777,27656,12772,484
48099,"Coryell County, Texas",75576,74082,74978,64213,56767,18809,489
48101,"Cottle County, Texas",1624,1618,1904,2247,2947,-1323,489
48103,"Crane County, Texas",4739,4141,3996,4652,4600,139,489
48105,"Crockett County, Texas",3393,3746,4099,4078,4608,-1215,489
48107,"Crosby County, Texas",5753,6207,7072,7304,8859,-3106,489
48109,"Culberson County, Texas",2183,2480,2975,3407,3315,-1132,489
48111,"Dallam County, Texas",7272,6471,6222,5461,6531,741,489
48113,"Dallas County, Texas",2622634,2321014,2218899,1852810,1556390,1066244,484
48115,"Dawson County, Texas",12849,13853,14985,14349,16184,-3335,489
48117,"Deaf Smith County, Texas",18617,19054,18561,19153,21165,-2548,489
48119,"Delta County, Texas",5277,5248,5327,4857,4839,438,484
48121,"Denton County, Texas",861690,628084,432976,273525,143126,718564,484
48123,"De Witt County, Texas",20217,20025,20013,18840,18903,1314,489
48125,"Dickens County, Texas",2182,2441,2762,2571,3539,-1357,489
48127,"Dimmit County, Texas",10232,9908,10248,10433,11367,-1135,489
48129,"Donley County, Texas",3317,3655,3828,3696,4075,-758,489
48131,"Duval County, Texas",11194,11999,13120,12918,12517,-1323,489
48133,"Eastland County, Texas",18289,18560,18297,18488,19480,-1191,489
48135,"Ector County, Texas",162067,133015,121123,118934,115374,46693,489
48137,"Edwards County, Texas",1944,2029,2162,2266,2033,-89,489
48139,"Ellis County, Texas",179484,143502,111360,85167,59743,119741,484
48141,"El Paso County, Texas",836915,772280,679622,591610,479899,357016,485
48143,"Erath County, Texas",42226,37142,33001,27991,22560,19666,489
48145,"Falls County, Texas",17281,17799,18576,17712,17946,-665,489
48147,"Fannin County, Texas",35046,33765,31242,24804,24285,10761,484
48149,"Fayette County, Texas",25247,24175,21804,20095,18832,6415,489
48151,"Fisher County, Texas",3827,4057,4344,4842,5891,-2064,489
48153,"Floyd County, Texas",5782,6599,7771,8497,9834,-4052,489
48155,"Foard County, Texas",1207,1379,1622,1794,2158,-951,489
48157,"Fort Bend County, Texas",790892,541983,354452,225421,130846,660046,486
48159,"Franklin County, Texas",10767,10675,9458,7802,6893,3874,489
48161,"Freestone County, Texas",19744,19461,17867,15818,14830,4914,489
48163,"Frio County, Texas",20013,16956,16252,13472,13785,6228,489
48165,"Gaines County, Texas",21077,16658,14467,14123,13150,7927,489
48167,"Galveston County, Texas",337600,286326,250158,217399,195940,141660,486
48169,"Garza County, Texas",6028,6204,4872,5143,5336,692,489
48171,"Gillespie County, Texas",26668,24197,20814,17204,13532,13136,489
48173,"Glasscock County, Texas",1447,1317,1406,1447,1304,143,489
48175,"Goliad County, Texas",7578,7161,6928,5980,5193,2385,489
48177,"Gonzales County, Texas",20828,19635,18628,17205,16883,3945,489
48179,"Gray County, Texas",22063,22497,22744,23967,26386,-4323,489
48181,"Grayson County, Texas",133527,119111,110595,95021,89796,43731,484
48183,"Gregg County, Texas",123633,119525,111379,104948,99487,24146,489
48185,"Grimes County, Texas",28447,26208,23552,18828,13580,14867,489
48187,"Guadalupe County, Texas",163030,122728,89023,64873,46708,116322,488
48189,"Hale County, Texas",33463,36041,36602,34671,37592,-4129,489
48191,"Hall County, Texas",3025,3424,3782,3905,5594,-2569,489
48193,"Hamilton County, Texas",8434,8473,8229,7733,8297,137,489
48195,"Hansford County, Texas",5431,5470,5369,5848,6209,-778,489
48197,"Hardeman County, Texas",3958,4226,4724,5283,6368,-2410,489
48199,"Hardin County, Texas",57356,53220,48073,41320,40721,16635,482
48201,"Harris County, Texas",4680609,3950999,3400578,2818199,2409547,2271062,486
48203,"Harrison County, Texas",66547,64484,62110,57483,52265,14282,489
48205,"Hartley County, Texas",5588,5963,5537,3634,3987,1601,489
48207,"Haskell County, Texas",5711,5842,6093,6820,7725,-2014,489
48209,"Hays County, Texas",222827,146439,97589,65614,40594,182233,481
48211,"Hemphill County, Texas",3901,3668,3351,3720,5304,-1403,489
48213,"Henderson County, Texas",81969,78299,73277,58543,42606,39363,484
48215,"Hidalgo County, Texas",861137,736973,569463,383545,283229,577908,489
48217,"Hill County, Texas",36109,34854,32321,27146,25024,11085,489
48219,"Hockley County, Texas",22986,22933,22716,24199,23230,-244,489
48221,"Hood County, Texas",60025,49816,41100,28981,17714,42311,484
48223,"Hopkins County, Texas",36708,34540,31960,28833,25247,11461,489
48225,"Houston County, Texas",22942,23642,23185,21375,22299,643,489
48227,"Howard County, Texas",36213,34285,33627,32343,33142,3071,489
48229,"Hudspeth County, Texas",4687,3441,3344,2915,2728,1959,489
48231,"Hunt County, Texas",96202,84836,76596,64343,55248,40954,484
48233,"Hutchinson County, Texas",21105,22094,23857,25689,26304,-5199,489
48235,"Irion County, Texas",1553,1673,1771,1629,1386,167,489
48237,"Jack County, Texas",8888,9072,8763,6981,7408,1480,489
48239,"Jackson County, Texas",14822,13987,14391,13039,13352,1470,489
48241,"Jasper County, Texas",35562,35248,35604,31102,30781,4781,489
48243,"Jeff Davis County, Texas",2245,2340,2207,1946,1647,598,489
48245,"Jefferson County, Texas",253136,249349,252051,239397,250938,2198,482
48247,"Jim Hogg County, Texas",5187,5211,5281,5109,5168,19,489
48249,"Jim Wells County, Texas",40796,40631,39326,37679,36498,4298,489
48251,"Johnson County, Texas",171359,147611,126811,97165,67649,103710,484
48253,"Jones County, Texas",19874,20157,20785,16490,17268,2606,489
48255,"Karnes County, Texas",15547,14880,15446,12455,13593,1954,489
48257,"Kaufman County, Texas",129792,98402,71313,52220,39015,90777,484
48259,"Kendall County, Texas",45491,31515,23743,14589,10635,34856,488
48261,"Kenedy County, Texas",391,241,414,460,543,-152,483
48263,"Kent County, Texas",704,772,859,1010,1145,-441,489
48265,"Kerr County, Texas",52195,48826,43653,36304,28780,23415,489
48267,"Kimble County, Texas",4375,4568,4468,4122,4063,312,489
48269,"King County, Texas",279,219,356,354,425,-146,489
48271,"Kinney County, Texas",3674,3555,3379,3119,2279,1395,489
48273,"Kleberg County, Texas",30725,31611,31549,30274,33358,-2633,483
48275,"Knox County, Texas",3679,3708,4253,4837,5329,-1650,489
48277,"Lamar County, Texas",49705,49536,48499,43949,42156,7549,489
48279,"Lamb County, Texas",13018,14092,14709,15072,18669,-5651,489
48281,"Lampasas County, Texas",21152,19677,17762,13521,12005,9147,489
48283,"La Salle County, Texas",7551,6709,5866,5254,5514,2037,489
48285,"Lavaca County, Texas",20072,19217,19210,18690,19004,1068,489
48287,"Lee County, Texas",17174,16499,15657,12854,10952,6222,489
48289,"Leon County, Texas",17325,16640,15335,12665,9594,7731,489
48291,"Liberty County, Texas",86173,74922,70154,52726,47088,39085,486
48293,"Limestone County, Texas",23364,23170,22051,20946,20224,3140,489
48295,"Lipscomb County, Texas",3301,3218,3057,3143,3766,-465,489
48297,"Live Oak County, Texas",12175,11507,12309,9556,9606,2569,489
48299,"Llano County, Texas",21452,18992,17044,11631,10144,11308,489
48301,"Loving County, Texas",117,41,67,107,91,26,489
48303,"Lubbock County, Texas",308392,269932,242628,222636,211651,96741,489
48305,"Lynn County, Texas",5886,5988,6550,6758,8605,-2719,489
48307,"Mcculloch County, Texas",7970,8220,8205,8778,8735,-765,489
48309,"Mclennan County, Texas",254045,229587,213517,189123,170755,83290,489
48311,"Mcmullen County, Texas",724,897,851,817,789,-65,489
48313,"Madison County, Texas",14329,13433,12940,10931,10649,3680,489
48315,"Marion County, Texas",9987,10771,10941,9984,10360,-373,489
48317,"Martin County, Texas",5676,4606,4746,4956,4684,992,489
48319,"Mason County, Texas",4248,3928,3738,3423,3683,565,489
48321,"Matagorda County, Texas",36791,36647,37957,36928,37828,-1037,486
48323,"Maverick County, Texas",58098,52493,47297,36378,31398,26700,489
48325,"Medina County, Texas",50869,45073,39304,27312,23164,27705,488
48327,"Menard County, Texas",2108,2212,2360,2252,2346,-238,489
48329,"Midland County, Texas",171238,132103,116009,106611,82636,88602,489
48331,"Milam County, Texas",24797,24934,24238,22946,22732,2065,489
48333,"Mills County, Texas",4877,4887,5151,4531,4477,400,489
48335,"Mitchell County, Texas",8256,9342,9698,8016,9088,-832,489
48337,"Montague County, Texas",19640,19789,19117,17274,17410,2230,489
48339,"Montgomery County, Texas",590188,427717,293768,182201,128487,461701,486
48341,"Moore County, Texas",21169,21102,20121,17865,16575,4594,489
48343,"Morris County, Texas",12357,13077,13048,13200,14629,-2272,489
48345,"Motley County, Texas",1362,1123,1426,1532,1950,-588,489
48347,"Nacogdoches County, Texas",65080,63141,59203,54753,46786,18294,489
48349,"Navarro County, Texas",49475,47483,45124,39926,35323,14152,489
48351,"Newton County, Texas",13788,14389,15072,13569,13254,534,489
48353,"Nolan County, Texas",14901,14990,15802,16594,17359,-2458,489
48355,"Nueces County, Texas",362151,334370,313645,291145,268215,93936,483
48357,"Ochiltree County, Texas",9907,9953,9006,9128,9588,319,489
48359,"Oldham County, Texas",2110,2020,2185,2278,2283,-173,489
48361,"Orange County, Texas",83776,82014,84966,80509,83838,-62,482
48363,"Palo Pinto County, Texas",28792,27927,27026,25055,24062,4730,484
48365,"Panola County, Texas",23186,23569,22756,22035,20724,2462,489
48367,"Parker County, Texas",138447,112158,88495,64785,44609,93838,484
48369,"Parmer County, Texas",9639,10098,10016,9863,11038,-1399,489
48371,"Pecos County, Texas",15725,15400,16809,14675,14618,1107,489
48373,"Polk County, Texas",50155,45590,41133,30687,24407,25748,489
48375,"Potter County, Texas",118323,120124,113546,97874,98637,19686,489
48377,"Presidio County, Texas",6808,7703,7304,6637,5188,1620,489
48379,"Rains County, Texas",12001,10942,9139,6715,4839,7162,489
48381,"Randall County, Texas",136005,116811,104312,89673,75062,60943,489
48383,"Reagan County, Texas",3766,3298,3326,4514,4135,-369,489
48385,"Real County, Texas",3429,3279,3047,2412,2469,960,489
48387,"Red River County, Texas",12115,12987,14314,14317,16101,-3986,489
48389,"Reeves County, Texas",15546,13269,13137,15852,15801,-255,489
48391,"Refugio County, Texas",7015,7434,7828,7976,9289,-2274,489
48393,"Roberts County, Texas",784,877,887,1025,1187,-403,489
48395,"Robertson County, Texas",17094,16574,16000,15511,14653,2441,489
48397,"Rockwall County, Texas",101175,73311,43080,25604,14528,86647,484
48399,"Runnels County, Texas",10280,10492,11495,11294,11872,-1592,489
48401,"Rusk County, Texas",53988,52016,47372,43735,41382,12606,489
48403,"Sabine County, Texas",10470,10653,10469,9586,8702,1768,489
48405,"San Augustine County, Texas",8260,8996,8946,7999,8785,-525,489
48407,"San Jacinto County, Texas",28574,25859,22246,16372,11434,17140,486
48409,"San Patricio County, Texas",66969,66100,67138,58749,58013,8956,483
48411,"San Saba County, Texas",6004,6023,6186,5401,6204,-200,489
48413,"Schleicher County, Texas",2898,3343,2935,2990,2820,78,489
48415,"Scurry County, Texas",16918,16579,16361,18634,18192,-1274,489
48417,"Shackelford County, Texas",3291,3182,3302,3316,3915,-624,489
48419,"Shelby County, Texas",25263,25423,25224,22034,23084,2179,489
48421,"Sherman County, Texas",3046,3000,3186,2858,3174,-128,489
48423,"Smith County, Texas",230184,203393,174706,151309,128366,101818,489
48425,"Somervell County, Texas",8958,8200,6809,5360,4154,4804,484
48427,"Starr County, Texas",64032,59989,53597,40518,27266,36766,489
48429,"Stephens County, Texas",9358,9562,9674,9010,9926,-568,489
48431,"Sterling County, Texas",1274,1160,1393,1438,1206,68,489
48433,"Stonewall County, Texas",1412,1434,1693,2013,2406,-994,489
48435,"Sutton County, Texas",3793,4257,4077,4135,5130,-1337,489
48437,"Swisher County, Texas",7403,7828,8378,8133,9723,-2320,489
48439,"Tarrant County, Texas",2077153,1743300,1446219,1170103,860880,1216273,484
48441,"Taylor County, Texas",137521,129477,126555,119655,110932,26589,489
48443,"Terrell County, Texas",903,850,1081,1410,1595,-692,489
48445,"Terry County, Texas",12408,12498,12761,13218,14581,-2173,489
48447,"Throckmorton County, Texas",1500,1814,1850,1880,2053,-553,489
48449,"Titus County, Texas",32709,30995,28118,24009,21442,11267,489
48451,"Tom Green County, Texas",118645,108000,104010,98458,84784,33861,489
48453,"Travis County, Texas",1250884,979712,812280,576407,419573,831311,481
48455,"Trinity County, Texas",14689,14451,13779,11445,9450,5239,489
48457,"Tyler County, Texas",21524,21472,20871,16646,16223,5301,489
48459,"Upshur County, Texas",41386,38685,35291,31370,28595,12791,489
48461,"Upton County, Texas",3651,3243,3404,4447,4619,-968,489
48463,"Uvalde County, Texas",26899,26285,25926,23340,22441,4458,489
48465,"Val Verde County, Texas",49018,48088,44856,38721,35910,13108,489
48467,"Van Zandt County, Texas",55970,52362,48140,37944,31426,24544,489
48469,"Victoria County, Texas",92044,85813,84088,74361,68807,23237,489
48471,"Walker County, Texas",72295,66353,61758,50917,41789,30506,486
48473,"Waller County, Texas",53626,40831,32663,23390,19798,33828,486
48475,"Ward County, Texas",11745,10505,10909,13115,13976,-2231,489
48477,"Washington County, Texas",35275,32949,30373,26154,21998,13277,489
48479,"Webb County, Texas",274847,240346,193117,133239,99258,175589,487
48481,"Wharton County, Texas",41672,41036,41188,39955,40242,1430,489
48483,"Wheeler County, Texas",5187,5235,5284,5879,7137,-1950,489
48485,"Wichita County, Texas",132154,130976,131664,122378,121082,11072,489
48487,"Wilbarger County, Texas",12717,13637,14676,15121,15931,-3214,489
48489,"Willacy County, Texas",21419,21769,20082,17705,17495,3924,489
48491,"Williamson County, Texas",570437,391715,249967,139551,76521,493916,481
48493,"Wilson County, Texas",50110,41264,32408,22650,16756,33354,488
48495,"Winkler County, Texas",7822,6933,7173,8626,9944,-2122,489
48497,"Wise County, Texas",67884,58054,48793,34679,26575,41309,484
48499,"Wood County, Texas",45054,41625,36752,29380,24697,20357,489
48501,"Yoakum County, Texas",8612,7706,7322,8786,8299,313,489
48503,"Young County, Texas",17961,18298,17943,18126,19083,-1122,489
48505,"Zapata County, Texas",14243,13609,12182,9279,6628,7615,489
48507,"Zavala County, Texas",11930,11658,11600,12162,11666,264,489
49001,"Beaver County, Utah",6594,6431,6005,4765,4378,2216,499
49003,"Box Elder County, Utah",54953,48221,42745,36485,33222,21731,491
49005,"Cache County, Utah",126336,107078,91391,70183,57176,69160,499
49007,"Carbon County, Utah",20401,20765,20422,20228,22179,-1778,499
49009,"Daggett County, Utah",590,839,921,690,769,-179,499
49011,"Davis County, Utah",350761,294532,238994,187941,146540,204221,491
49013,"Duchesne County, Utah",19950,17408,14371,12645,12565,7385,499
49015,"Emery County, Utah",10099,10728,10860,10332,11451,-1352,499
49017,"Garfield County, Utah",5000,4958,4735,3980,3673,1327,499
49019,"Grand County, Utah",9698,8987,8485,6620,8241,1457,499
49021,"Iron County, Utah",53148,44439,33779,20789,17349,35799,499
49023,"Juab County, Utah",11623,9855,8238,5817,5530,6093,499
49025,"Kane County, Utah",7658,6893,6046,5169,4024,3634,499
49027,"Millard County, Utah",12963,12189,12405,11333,8970,3993,499
49029,"Morgan County, Utah",11950,9013,7129,5528,4917,7033,491
49031,"Piute County, Utah",1870,1661,1435,1277,1329,541,499
49033,"Rich County, Utah",2415,2181,1961,1725,2100,315,499
49035,"Salt Lake County, Utah",1146215,1000155,898387,725956,619066,527149,491
49037,"San Juan County, Utah",15295,14299,14413,12621,12253,3042,499
49039,"Sanpete County, Utah",30421,26651,22763,16259,14620,15801,499
49041,"Sevier County, Utah",21475,20438,18842,15431,14727,6748,499
49043,"Summit County, Utah",41680,35295,29736,15518,10198,31482,491
49045,"Tooele County, Utah",69740,55398,40735,26601,26033,43707,491
49047,"Uintah County, Utah",35736,30991,25224,22211,20506,15230,499
49049,"Utah County, Utah",621506,486067,368536,263590,218106,403400,499
49051,"Wasatch County, Utah",33053,22176,15215,10089,8523,24530,491
49053,"Washington County, Utah",172127,134033,90354,48560,26065,146062,499
49055,"Wayne County, Utah",2698,2706,2509,2177,1911,787,499
49057,"Weber County, Utah",255284,222849,196533,158330,144616,110668,491
50001,"Addison County, Vermont",36947,36841,35974,32953,29406,7541,500
50003,"Bennington County, Vermont",35649,37122,36994,35845,33345,2304,500
50005,"Caledonia County, Vermont",30027,31214,29702,27846,25808,4219,500
50007,"Chittenden County, Vermont",163414,154729,146571,131761,115534,47880,500
50009,"Essex County, Vermont",6179,6359,6459,6405,6313,-134,500
50011,"Franklin County, Vermont",49275,47547,45417,39980,34788,14487,500
50013,"Grand Isle County, Vermont",7075,7105,6901,5318,4613,2462,500
50015,"Lamoille County, Vermont",25376,24040,23233,19735,16767,8609,500
50017,"Orange County, Vermont",28873,29059,28226,26149,22739,6134,500
50019,"Orleans County, Vermont",26843,27256,26277,24053,23440,3403,500
50021,"Rutland County, Vermont",58527,62278,63400,62142,58347,180,500
50023,"Washington County, Vermont",58336,59379,58039,54928,52393,5943,500
50025,"Windham County, Vermont",42628,44438,44216,41588,36933,5695,500
50027,"Windsor County, Vermont",55191,56891,57418,54055,51030,4161,500
51001,"Accomack County, Virginia",32560,34066,38305,31703,31268,1292,519
51003,"Albemarle County, Virginia",108819,96633,79236,68040,55783,53036,519
51005,"Alleghany County, Virginia",15030,16406,12926,13176,14333,697,519
51007,"Amelia County, Virginia",12970,12517,11400,8787,8405,4565,511
51009,"Amherst County, Virginia",31782,32315,31894,28578,29122,2660,519
51011,"Appomattox County, Virginia",15814,14653,13705,12298,11971,3843,519
51013,"Arlington County, Virginia",236434,197467,189453,170936,152599,83835,513
51015,"Augusta County, Virginia",75754,73201,65615,54677,53732,22022,519
51017,"Bath County, Virginia",4248,4779,5048,4799,5860,-1612,519
51019,"Bedford County, Virginia",78965,67697,60371,45656,34927,44038,519
51021,"Bland County, Virginia",6334,6873,6871,6514,6349,-15,519
51023,"Botetourt County, Virginia",33440,32867,30496,24992,23270,10170,519
51025,"Brunswick County, Virginia",16336,17707,18419,15987,15632,704,519
51027,"Buchanan County, Virginia",21374,24459,26978,31333,37989,-16615,519
51029,"Buckingham County, Virginia",17087,16874,15623,12873,11751,5336,519
51031,"Campbell County, Virginia",55406,54174,51078,47572,45424,9982,519
51033,"Caroline County, Virginia",30581,27844,22121,19217,17904,12677,511
51035,"Carroll County, Virginia",29911,29985,29245,26594,27270,2641,519
51036,"Charles City County, Virginia",6965,7205,6926,6282,6692,273,511
51037,"Charlotte County, Virginia",11953,12644,12472,11688,12266,-313,519
51041,"Chesterfield County, Virginia",348500,308633,259903,209274,141372,207128,511
51043,"Clarke County, Virginia",14498,14013,12652,12101,9965,4533,513
51045,"Craig County, Virginia",5103,5173,5091,4372,3948,1155,519
51047,"Culpeper County, Virginia",51935,45749,34262,27791,22620,29315,513
51049,"Cumberland County, Virginia",9869,9855,9017,7825,7881,1988,511
51051,"Dickenson County, Virginia",14524,15966,16395,17620,19806,-5282,519
51053,"Dinwiddie County, Virginia",28686,27449,24533,20960,22602,6084,511
51057,"Essex County, Virginia",10960,10901,9989,8689,8864,2096,519
51059,"Fairfax County, Virginia",1149439,1048554,969749,818584,596901,552538,513
51061,"Fauquier County, Virginia",70353,64546,55139,48741,35889,34464,513
51063,"Floyd County, Virginia",15766,15030,13874,12005,11563,4203,519
51065,"Fluvanna County, Virginia",26873,25308,20047,12429,10244,16629,519
51067,"Franklin County, Virginia",56231,54938,47286,39549,35740,20491,519
51069,"Frederick County, Virginia",88054,75835,59209,45723,34150,53904,513
51071,"Giles County, Virginia",16760,17205,16657,16366,17810,-1050,519
51073,"Gloucester County, Virginia",37362,36610,34780,30131,20107,17255,512
51075,"Goochland County, Virginia",23472,21136,16863,14163,11761,11711,511
51077,"Grayson County, Virginia",15651,15855,17917,16278,16579,-928,519
51079,"Greene County, Virginia",19734,18082,15244,10297,7625,12109,519
51081,"Greensville County, Virginia",11403,12181,11560,8853,10903,500,519
51083,"Halifax County, Virginia",34295,36311,37355,29033,30599,3696,519
51085,"Hanover County, Virginia",106538,99172,86320,63306,50398,56140,511
51087,"Henrico County, Virginia",330076,300053,262300,217881,180735,149341,511
51089,"Henry County, Virginia",51032,54860,57930,56942,57654,-6622,519
51091,"Highland County, Virginia",2202,2395,2536,2635,2937,-735,519
51093,"Isle Of Wight County, Virginia",37107,34762,29728,25053,21603,15504,512
51095,"James City County, Virginia",76032,64386,48102,34859,22763,53269,512
51097,"King And Queen County, Virginia",7011,6926,6630,6289,5968,1043,511
51099,"King George County, Virginia",26679,22794,16803,13527,10543,16136,519
51101,"King William County, Virginia",16985,15509,13146,10913,9334,7651,511
51103,"Lancaster County, Virginia",10686,11478,11567,10896,10129,557,519
51105,"Lee County, Virginia",23723,25434,23589,24496,25956,-2233,519
51107,"Loudoun County, Virginia",405312,291653,169599,86129,57427,347885,513
51109,"Louisa County, Virginia",36654,32248,25627,20325,17825,18829,511
51111,"Lunenburg County, Virginia",12294,12968,13146,11419,12124,170,519
51113,"Madison County, Virginia",13208,13342,12520,11949,10232,2976,519
51115,"Mathews County, Virginia",8760,9004,9207,8348,7995,765,512
51117,"Mecklenburg County, Virginia",30726,32774,32380,29241,29444,1282,519
51119,"Middlesex County, Virginia",10642,10831,9932,8653,7719,2923,519
51121,"Montgomery County, Virginia",98495,92527,83629,73913,63516,34979,519
51125,"Nelson County, Virginia",14812,14989,14445,12778,12204,2608,519
51127,"New Kent County, Virginia",22310,17655,13462,10445,8781,13529,511
51131,"Northampton County, Virginia",11826,12572,13093,13061,14625,-2799,519
51133,"Northumberland County, Virginia",12151,12419,12259,10524,9828,2323,519
51135,"Nottoway County, Virginia",15338,15819,15725,14993,14666,672,519
51137,"Orange County, Virginia",36501,32730,25881,21421,18063,18438,519
51139,"Page County, Virginia",23862,24116,23177,21690,19401,4461,519
51141,"Patrick County, Virginia",17660,18643,19407,17473,17647,13,519
51143,"Pittsylvania County, Virginia",60867,63147,61745,55655,66147,-5280,519
51145,"Powhatan County, Virginia",29253,27758,22377,15328,13062,16191,511
51147,"Prince Edward County, Virginia",22892,22723,19720,17320,16456,6436,519
51149,"Prince George County, Virginia",38292,35129,33047,27394,25733,12559,511
51153,"Prince William County, Virginia",466834,379415,280813,215686,144703,322131,513
51155,"Pulaski County, Virginia",34113,34963,35127,34496,35229,-1116,519
51157,"Rappahannock County, Virginia",7360,7376,6983,6622,6093,1267,519
51159,"Richmond County, Virginia",8951,9328,8809,7273,6952,1999,519
51161,"Roanoke County, Virginia",94103,91583,85778,79332,72945,21158,519
51163,"Rockbridge County, Virginia",22728,22217,20808,18350,17911,4817,519
51165,"Rockingham County, Virginia",81138,74922,67725,57482,57038,24100,519
51167,"Russell County, Virginia",26937,28842,30308,28667,31761,-4824,519
51169,"Scott County, Virginia",21761,23234,23403,23204,25068,-3307,519
51171,"Shenandoah County, Virginia",43441,41468,35075,31636,27559,15882,519
51173,"Smyth County, Virginia",30539,32383,33081,32370,33366,-2827,519
51175,"Southampton County, Virginia",17829,18493,17482,17550,18731,-902,519
51177,"Spotsylvania County, Virginia",134683,120212,90395,57403,34435,100248,513
51179,"Stafford County, Virginia",150185,124587,92446,61236,40470,109715,513
51181,"Surry County, Virginia",6459,7039,6829,6145,6046,413,512
51183,"Sussex County, Virginia",11202,12167,12504,10248,10874,328,511
51185,"Tazewell County, Virginia",41201,44706,44598,45960,50511,-9310,519
51187,"Warren County, Virginia",39888,37044,31584,26142,21200,18688,513
51191,"Washington County, Virginia",54005,54322,51103,45887,46487,7518,519
51193,"Westmoreland County, Virginia",17873,17237,16718,15480,14041,3832,519
51195,"Wise County, Virginia",38032,41496,40123,39573,43863,-5831,519
51197,"Wythe County, Virginia",28725,29005,27599,25466,25522,3203,519
51199,"York County, Virginia",68389,64846,56297,42422,35463,32926,512
51510,"Alexandria City, Virginia",158309,133647,128283,111183,103217,55092,513
51520,"Bristol City, Virginia",17059,17704,17367,18426,19042,-1983,519
51530,"Buena Vista City, Virginia",6477,6653,6349,6406,6717,-240,519
51540,"Charlottesville City, Virginia",47217,42267,45049,40341,39916,7301,519
51550,"Chesapeake City, Virginia",242647,219268,199184,151976,114486,128161,512
51570,"Colonial Heights City, Virginia",17283,17472,16897,16064,16509,774,511
51580,"Covington City, Virginia",5653,5989,6303,6991,9063,-3410,519
51590,"Danville City, Virginia",40668,43787,48411,53056,45642,-4974,519
51595,"Emporia City, Virginia",5408,5822,5665,5306,4840,568,519
51600,"Fairfax City, Virginia",23312,22058,21498,19622,19390,3922,513
51610,"Falls Church City, Virginia",14309,11465,10377,9578,9515,4794,513
51620,"Franklin City, Virginia",8015,8549,8346,7864,7308,707,519
51630,"Fredericksburg City, Virginia",29059,23375,19279,19027,15322,13737,513
51640,"Galax City, Virginia",6402,6936,6837,6670,6524,-122,519
51650,"Hampton City, Virginia",135169,139046,146437,133793,122617,12552,512
51660,"Harrisonburg City, Virginia",53558,47406,40468,30707,19671,33887,519
51670,"Hopewell City, Virginia",22500,22506,22354,23101,23397,-897,511
51678,"Lexington City, Virginia",7205,6990,6867,6959,7292,-87,519
51680,"Lynchburg City, Virginia",80970,73726,65269,66049,66743,14227,519
51683,"Manassas City, Virginia",41038,36067,35135,27957,15438,25600,513
51685,"Manassas Park City, Virginia",17548,13195,10290,6734,6524,11024,513
51690,"Martinsville City, Virginia",12646,14029,15416,16162,18149,-5503,519
51700,"Newport News City, Virginia",179582,181822,180150,170045,144903,34679,512
51710,"Norfolk City, Virginia",244300,242143,234403,261229,266979,-22679,512
51720,"Norton City, Virginia",3969,3886,3904,4247,4757,-788,519
51730,"Petersburg City, Virginia",30791,32303,33740,38386,41055,-10264,511
51735,"Poquoson City, Virginia",12121,12099,11566,11005,8726,3395,512
51740,"Portsmouth City, Virginia",94961,96785,100565,103907,104577,-9616,512
51750,"Radford City, Virginia",17833,16318,15859,15940,13225,4608,519
51760,"Richmond City, Virginia",229233,201828,197790,203056,219214,10019,511
51770,"Roanoke City, Virginia",99122,95793,94911,96397,100220,-1098,519
51775,"Salem City, Virginia",25290,24641,24747,23756,23958,1332,519
51790,"Staunton City, Virginia",24660,23806,23853,24461,21857,2803,519
51800,"Suffolk City, Virginia",91383,82544,63677,52141,47621,43762,512
51810,"Virginia Beach City, Virginia",450882,435996,425257,393069,262199,188683,512
51820,"Waynesboro City, Virginia",22300,20885,19520,18549,15329,6971,519
51830,"Williamsburg City, Virginia",15034,13421,11998,11530,9870,5164,512
51840,"Winchester City, Virginia",27912,25953,23585,21947,20217,7695,513
53001,"Adams County, Washington",19702,17884,16428,13603,13267,6435,539
53003,"Asotin County, Washington",22636,21363,20551,17605,16823,5813,539
53005,"Benton County, Washington",200715,167077,142475,112560,109444,91271,539
53007,"Chelan County, Washington",76653,70995,66616,52250,45061,31592,539
53009,"Clallam County, Washington",76482,70638,64525,56464,51648,24834,539
53011,"Clark County, Washington",481950,414816,345238,238053,192227,289723,539
53013,"Columbia County, Washington",4024,3957,4064,4024,4057,-33,539
53015,"Cowlitz County, Washington",108399,101244,92948,82119,79548,28851,539
53017,"Douglas County, Washington",42520,37160,32603,26205,22144,20376,539
53019,"Ferry County, Washington",7643,7504,7260,6295,5811,1832,539
53021,"Franklin County, Washington",93681,71329,49347,37473,35025,58656,539
53023,"Garfield County, Washington",2258,2240,2397,2248,2468,-210,539
53025,"Grant County, Washington",96648,85142,74698,54758,48522,48126,539
53027,"Grays Harbor County, Washington",73769,72092,67194,64175,66314,7455,539
53029,"Island County, Washington",84187,78633,71558,60195,44048,40139,531
53031,"Jefferson County, Washington",31825,29574,25953,20146,15965,15860,539
53033,"King County, Washington",2225064,1879189,1737034,1507319,1269749,955315,531
53035,"Kitsap County, Washington",268945,247336,231969,189731,147152,121793,531
53037,"Kittitas County, Washington",47097,39869,33362,26725,24877,22220,539
53039,"Klickitat County, Washington",22055,20055,19161,16616,15822,6233,539
53041,"Lewis County, Washington",79430,74650,68600,59358,56025,23405,539
53043,"Lincoln County, Washington",10732,10533,10184,8864,9604,1128,539
53045,"Mason County, Washington",65326,59287,49405,38341,31184,34142,531
53047,"Okanogan County, Washington",42080,40238,39564,33350,30639,11441,539
53049,"Pacific County, Washington",22121,21192,20984,18882,17237,4884,539
53051,"Pend Oreille County, Washington",13588,12904,11732,8915,8580,5008,539
53053,"Pierce County, Washington",891862,782681,700820,586203,485643,406219,531
53055,"San Juan County, Washington",16953,15551,14077,10035,7838,9115,539
53057,"Skagit County, Washington",127442,115231,102979,79555,64138,63304,531
53059,"Skamania County, Washington",11906,10869,9872,8289,7919,3987,539
53061,"Snohomish County, Washington",811572,694219,606024,465642,337720,473852,531
53063,"Spokane County, Washington",513402,461262,417939,361364,341835,171567,539
53065,"Stevens County, Washington",45233,43171,40066,30948,28979,16254,539
53067,"Thurston County, Washington",284698,243563,207355,161238,124264,160434,531
53069,"Wahkiakum County, Washington",4318,3982,3824,3327,3832,486,539
53071,"Walla Walla County, Washington",60785,57585,55180,48439,47435,13350,539
53073,"Whatcom County, Washington",224538,195993,166814,127780,106701,117837,539
53075,"Whitman County, Washington",49577,43747,40740,38775,40103,9474,539
53077,"Yakima County, Washington",250649,236542,222581,188823,172508,78141,539
54001,"Barbour County, West Virginia",16543,16256,15557,15699,16639,-96,540
54003,"Berkeley County, West Virginia",117615,100910,75905,59253,46775,70840,540
54005,"Boone County, West Virginia",21897,24872,25535,25870,30447,-8550,540
54007,"Braxton County, West Virginia",14032,14558,14702,12998,13894,138,540
54009,"Brooke County, West Virginia",22162,24194,25447,26992,31117,-8955,540
54011,"Cabell County, West Virginia",93328,95526,96784,96827,106835,-13507,540
54013,"Calhoun County, West Virginia",7185,7588,7582,7885,8250,-1065,540
54015,"Clay County, West Virginia",8599,9572,10330,9983,11265,-2666,540
54017,"Doddridge County, West Virginia",8499,8035,7403,6994,7433,1066,540
54019,"Fayette County, West Virginia",43087,46138,47579,47952,57863,-14776,540
54021,"Gilmer County, West Virginia",7970,8394,7160,7669,8334,-364,540
54023,"Grant County, West Virginia",11565,11942,11299,10428,10210,1355,540
54025,"Greenbrier County, West Virginia",34893,35373,34453,34693,37665,-2772,540
54027,"Hampshire County, West Virginia",23304,23594,20203,16498,14867,8437,540
54029,"Hancock County, West Virginia",29118,30866,32667,35233,40418,-11300,540
54031,"Hardy County, West Virginia",13789,13832,12669,10977,10030,3759,540
54033,"Harrison County, West Virginia",67620,68490,68652,69371,77710,-10090,540
54035,"Jackson County, West Virginia",28793,29084,28000,25938,25794,2999,540
54037,"Jefferson County, West Virginia",56922,52033,42190,35926,30302,26620,540
54039,"Kanawha County, West Virginia",181014,192770,200073,207619,231414,-50400,540
54041,"Lewis County, West Virginia",16024,16406,16919,17223,18813,-2789,540
54043,"Lincoln County, West Virginia",20617,21879,22108,21382,23675,-3058,540
54045,"Logan County, West Virginia",32593,36564,37710,43032,50679,-18086,540
54047,"Mcdowell County, West Virginia",18083,22555,27329,35233,49899,-31816,540
54049,"Marion County, West Virginia",56233,56356,56598,57249,65789,-9556,540
54051,"Marshall County, West Virginia",30900,33369,35519,37356,41608,-10708,540
54053,"Mason County, West Virginia",26700,27016,25957,25178,27045,-345,540
54055,"Mercer County, West Virginia",59370,61844,62980,64980,73942,-14572,540
54057,"Mineral County, West Virginia",27047,27796,27078,26697,27234,-187,540
54059,"Mingo County, West Virginia",23808,26956,28253,33739,37336,-13528,540
54061,"Monongalia County, West Virginia",106196,92715,81866,75509,75024,31172,540
54063,"Monroe County, West Virginia",13344,13495,14583,12406,12873,471,540
54065,"Morgan County, West Virginia",17800,17409,14943,12128,10711,7089,540
54067,"Nicholas County, West Virginia",24857,26189,26562,26775,28126,-3269,540
54069,"Ohio County, West Virginia",41875,44582,47427,50871,61389,-19514,540
54071,"Pendleton County, West Virginia",6968,7773,8196,8054,7910,-942,540
54073,"Pleasants County, West Virginia",7457,7664,7514,7546,8236,-779,540
54075,"Pocahontas County, West Virginia",8382,8808,9131,9008,9919,-1537,540
54077,"Preston County, West Virginia",33610,32976,29334,29037,30460,3150,540
54079,"Putnam County, West Virginia",56604,54940,51589,42835,38181,18423,540
54081,"Raleigh County, West Virginia",74452,78513,79220,76819,86821,-12369,540
54083,"Randolph County, West Virginia",28763,29233,28262,27803,28734,29,540
54085,"Ritchie County, West Virginia",9747,10514,10343,10233,11442,-1695,540
54087,"Roane County, West Virginia",13831,15116,15446,15120,15952,-2121,540
54089,"Summers County, West Virginia",12710,13847,12999,14204,15875,-3165,540
54091,"Taylor County, West Virginia",16817,16732,16089,15144,16584,233,540
54093,"Tucker County, West Virginia",6943,7137,7321,7728,8675,-1732,540
54095,"Tyler County, West Virginia",8736,9339,9592,9796,11320,-2584,540
54097,"Upshur County, West Virginia",24451,23984,23404,22867,23427,1024,540
54099,"Wayne County, West Virginia",39952,42647,42903,41636,46021,-6069,540
54101,"Webster County, West Virginia",8289,9247,9719,10729,12245,-3956,540
54103,"Wetzel County, West Virginia",15291,16697,17693,19258,21874,-6583,540
54105,"Wirt County, West Virginia",5764,5753,5873,5192,4922,842,540
54107,"Wood County, West Virginia",84387,86731,87986,86915,93648,-9261,540
54109,"Wyoming County, West Virginia",20890,23993,25708,28990,35993,-15103,540
55001,"Adams County, Wisconsin",20208,21044,18643,15682,13457,6751,559
55003,"Ashland County, Wisconsin",15524,16212,16866,16307,16783,-1259,559
55005,"Barron County, Wisconsin",45182,45915,44963,40750,38730,6452,559
55007,"Bayfield County, Wisconsin",15088,15114,15013,14008,13822,1266,559
55009,"Brown County, Wisconsin",262559,244376,226778,194594,175280,87279,559
55011,"Buffalo County, Wisconsin",13087,13744,13804,13584,14309,-1222,559
55013,"Burnett County, Wisconsin",15363,15749,15674,13084,12340,3023,559
55015,"Calumet County, Wisconsin",50005,47902,40631,34291,30867,19138,559
55017,"Chippewa County, Wisconsin",64175,61466,55195,52360,52127,12048,559
55019,"Clark County, Wisconsin",34668,34552,33557,31647,32910,1758,559
55021,"Columbia County, Wisconsin",57331,56350,52468,45088,43222,14109,559
55023,"Crawford County, Wisconsin",16155,16801,17243,15940,16556,-401,559
55025,"Dane County, Wisconsin",542459,477748,426526,367085,323545,218914,559
55027,"Dodge County, Wisconsin",87569,88935,85897,76559,75064,12505,559
55029,"Door County, Wisconsin",27621,27959,27961,25690,25029,2592,559
55031,"Douglas County, Wisconsin",43497,43907,43287,41758,44421,-924,559
55033,"Dunn County, Wisconsin",45029,43365,39858,35909,34314,10715,559
55035,"Eau Claire County, Wisconsin",104132,97381,93142,85183,78805,25327,559
55037,"Florence County, Wisconsin",4312,4587,5088,4590,4172,140,559
55039,"Fond Du Lac County, Wisconsin",102654,100919,97296,90083,88964,13690,559
55041,"Forest County, Wisconsin",9003,9534,10024,8776,9044,-41,559
55043,"Grant County, Wisconsin",51570,50716,49597,49264,51736,-166,559
55045,"Green County, Wisconsin",36790,36448,33647,30339,30012,6778,559
55047,"Green Lake County, Wisconsin",18807,19107,19105,18651,18370,437,559
55049,"Iowa County, Wisconsin",23632,23646,22780,20150,19802,3830,559
55051,"Iron County, Wisconsin",5679,6075,6861,6153,6730,-1051,559
55053,"Jackson County, Wisconsin",20556,20284,19100,16588,16831,3725,559
55055,"Jefferson County, Wisconsin",84837,82778,74021,67783,66152,18685,559
55057,"Juneau County, Wisconsin",26603,26733,24316,21650,21039,5564,559
55059,"Kenosha County, Wisconsin",168998,164328,149577,128181,123137,45861,559
55061,"Kewaunee County, Wisconsin",20398,20642,20187,18878,19539,859,559
55063,"La Crosse County, Wisconsin",118168,112819,107120,97904,91056,27112,559
55065,"Lafayette County, Wisconsin",16682,16775,16137,16076,17412,-730,559
55067,"Langlade County, Wisconsin",19167,20218,20740,19505,19978,-811,559
55069,"Lincoln County, Wisconsin",27687,29075,29641,26993,26555,1132,559
55071,"Manitowoc County, Wisconsin",78977,81678,82887,80421,82918,-3941,559
55073,"Marathon County, Wisconsin",135485,132644,125834,115400,111270,24215,559
55075,"Marinette County, Wisconsin",40312,42019,43384,40548,39314,998,559
55077,"Marquette County, Wisconsin",15380,15421,15832,12321,11672,3708,559
55078,"Menominee County, Wisconsin",4566,4251,4562,3890,3373,1193,559
55079,"Milwaukee County, Wisconsin",949180,937616,940164,959275,964988,-15808,551
55081,"Monroe County, Wisconsin",46155,44053,40899,36633,35074,11081,559
55083,"Oconto County, Wisconsin",37870,37737,35634,30226,28947,8923,559
55085,"Oneida County, Wisconsin",35480,36379,36776,31679,31216,4264,559
55087,"Outagamie County, Wisconsin",186829,174457,160971,140510,128799,58030,559
55089,"Ozaukee County, Wisconsin",89179,85945,82317,72831,66981,22198,551
55091,"Pepin County, Wisconsin",7261,7517,7213,7107,7477,-216,559
55093,"Pierce County, Wisconsin",42336,40530,36804,32765,31149,11187,559
55095,"Polk County, Wisconsin",43549,44310,41319,34773,32351,11198,559
55097,"Portage County, Wisconsin",70822,69437,67182,61405,57420,13402,559
55099,"Price County, Wisconsin",13351,14452,15822,15600,15788,-2437,559
55101,"Racine County, Wisconsin",195859,194736,188831,175034,173132,22727,551
55103,"Richland County, Wisconsin",17408,18205,17924,17521,17476,-68,559
55105,"Rock County, Wisconsin",162532,159964,152307,139510,139420,23112,559
55107,"Rusk County, Wisconsin",14074,14855,15347,15079,15589,-1515,559
55109,"St. Croix County, Wisconsin",89702,82636,63155,50251,43262,46440,559
55111,"Sauk County, Wisconsin",64152,60957,55225,46975,43469,20683,559
55113,"Sawyer County, Wisconsin",16477,16615,16196,14181,12843,3634,559
55115,"Shawano County, Wisconsin",40813,41842,40664,37157,35928,4885,559
55117,"Sheboygan County, Wisconsin",115152,115328,112646,103877,100935,14217,559
55119,"Taylor County, Wisconsin",20320,20557,19680,18901,18817,1503,559
55121,"Trempealeau County, Wisconsin",29525,28523,27010,25263,26158,3367,559
55123,"Vernon County, Wisconsin",30759,29460,28056,25617,25642,5117,559
55125,"Vilas County, Wisconsin",21923,21750,21033,17707,16535,5388,559
55127,"Walworth County, Wisconsin",103391,101735,93759,75000,71507,31884,559
55129,"Washburn County, Wisconsin",15726,16001,16036,13772,13174,2552,559
55131,"Washington County, Wisconsin",135529,130206,117493,95328,84848,50681,551
55133,"Waukesha County, Wisconsin",402637,386130,360767,304715,280326,122311,551
55135,"Waupaca County, Wisconsin",50997,52533,51731,46104,42831,8166,559
55137,"Waushara County, Wisconsin",24256,24631,23154,19385,18526,5730,559
55139,"Winnebago County, Wisconsin",170924,165032,156763,140320,131703,39221,559
55141,"Wood County, Wisconsin",72892,74601,75555,73605,72799,93,559
56001,"Albany County, Wyoming",38664,34926,32014,30797,29062,9602,560
56003,"Big Horn County, Wyoming",11809,11448,11461,10525,11896,-87,560
56005,"Campbell County, Wyoming",46958,43179,33698,29370,24367,22591,560
56007,"Carbon County, Wyoming",15073,15624,15639,16659,21896,-6823,560
56009,"Converse County, Wyoming",13842,13404,12052,11128,14069,-227,560
56011,"Crook County, Wyoming",7502,6761,5887,5294,5308,2194,560
56013,"Fremont County, Wyoming",39711,38875,35804,33662,38992,719,560
56015,"Goshen County, Wyoming",13301,12844,12538,12373,12040,1261,560
56017,"Hot Springs County, Wyoming",4550,4720,4882,4809,5710,-1160,560
56019,"Johnson County, Wyoming",8518,8307,7075,6145,6700,1818,560
56021,"Laramie County, Wyoming",99272,89221,81607,73142,68649,30623,560
56023,"Lincoln County, Wyoming",19640,17447,14573,12625,12177,7463,560
56025,"Natrona County, Wyoming",80067,73520,66533,61226,71856,8211,560
56027,"Niobrara County, Wyoming",2377,2430,2407,2499,2924,-547,560
56029,"Park County, Wyoming",29273,27574,25786,23178,21639,7634,560
56031,"Platte County, Wyoming",8572,8655,8807,8145,11975,-3403,560
56033,"Sheridan County, Wyoming",30397,28380,26560,23562,25048,5349,560
56035,"Sublette County, Wyoming",9865,9322,5920,4843,4548,5317,560
56037,"Sweetwater County, Wyoming",43352,42266,37613,38823,41723,1629,560
56039,"Teton County, Wyoming",23356,20802,18251,11172,9355,14001,560
56041,"Uinta County, Wyoming",20374,20537,19742,18705,13021,7353,560
56043,"Washakie County, Wyoming",7933,8271,8289,8388,9496,-1563,560
56045,"Weston County, Wyoming",6942,7066,6644,6518,7106,-164,560
