,Geo_FIPS,Geo_QName,income_per_capita_2020,income_per_capita_2010,income_per_capita_2000,income_per_capita_1990,income_per_capita_1980,income_changes
0,1001,"Autauga County, Alabama",29804,24568.0,18518,11182,5774,24030
1,1003,"Baldwin County, Alabama",33751,26469.0,20826,12275,5960,27791
2,1005,"Barbour County, Alabama",20074,15875.0,13316,9515,4544,15530
3,1007,"Bibb County, Alabama",22626,19918.0,14105,8973,4859,17767
4,1009,"Blount County, Alabama",25457,21070.0,16325,10168,5213,20244
5,1011,"Bullock County, Alabama",20783,20289.0,10163,6922,3961,16822
6,1013,"Butler County, Alabama",23415,16916.0,15715,7903,4594,18821
7,1015,"Calhoun County, Alabama",26238,20574.0,17367,10704,5596,20642
8,1017,"Chambers County, Alabama",24088,16626.0,15147,10000,5171,18917
9,1019,"Cherokee County, Alabama",26231,21322.0,15543,9915,5436,20795
10,1021,"Chilton County, Alabama",25894,20517.0,15303,9826,5153,20741
11,1023,"Choctaw County, Alabama",23292,17214.0,14635,9622,4657,18635
12,1025,"Clarke County, Alabama",24574,17372.0,14581,9031,5041,19533
13,1027,"Clay County, Alabama",25337,18332.0,13785,9533,4855,20482
14,1029,"Cleburne County, Alabama",24723,17490.0,14762,9876,5013,19710
15,1031,"Coffee County, Alabama",27912,22797.0,18321,11286,5714,22198
16,1033,"Colbert County, Alabama",25807,21079.0,17533,11425,6256,19551
17,1035,"Conecuh County, Alabama",20756,15755.0,12964,7953,4504,16252
18,1037,"Coosa County, Alabama",25083,19209.0,14875,9234,4912,20171
19,1039,"Covington County, Alabama",25303,19822.0,15365,9315,5186,20117
20,1041,"Crenshaw County, Alabama",26351,19793.0,14565,8848,4339,22012
21,1043,"Cullman County, Alabama",24770,20284.0,16922,10447,5444,19326
22,1045,"Dale County, Alabama",24473,21722.0,16010,10580,5313,19160
23,1047,"Dallas County, Alabama",19653,16646.0,13638,8344,4654,14999
24,1049,"De Kalb County, Alabama",22511,18152.0,15818,9604,5294,17217
25,1051,"Elmore County, Alabama",29585,22640.0,17650,10677,5765,23820
26,1053,"Escambia County, Alabama",18587,16259.0,14396,8858,5034,13553
27,1055,"Etowah County, Alabama",25094,20439.0,16783,10997,6105,18989
28,1057,"Fayette County, Alabama",23389,17711.0,14439,9864,5300,18089
29,1059,"Franklin County, Alabama",21503,18094.0,14814,9049,5454,16049
30,1061,"Geneva County, Alabama",22415,18351.0,14620,9768,5585,16830
31,1063,"Greene County, Alabama",16425,14738.0,13686,6306,3532,12893
32,1065,"Hale County, Alabama",20652,16523.0,12661,8164,3735,16917
33,1067,"Henry County, Alabama",26011,19716.0,15681,9909,4880,21131
34,1069,"Houston County, Alabama",27794,22725.0,18759,12118,6094,21700
35,1071,"Jackson County, Alabama",23844,18905.0,16000,10144,5452,18392
36,1073,"Jefferson County, Alabama",33343,26529.0,20892,13277,7070,26273
37,1075,"Lamar County, Alabama",22299,19789.0,14435,9945,5098,17201
38,1077,"Lauderdale County, Alabama",28540,22341.0,18626,11685,6283,22257
39,1079,"Lawrence County, Alabama",24779,19370.0,16515,9800,4804,19975
40,1081,"Lee County, Alabama",28804,22794.0,17158,11409,5638,23166
41,1083,"Limestone County, Alabama",28695,24007.0,17782,11696,5579,23116
42,1085,"Lowndes County, Alabama",21298,16524.0,12457,6848,3389,17909
43,1087,"Macon County, Alabama",22170,16380.0,13714,7534,4046,18124
44,1089,"Madison County, Alabama",38192,29918.0,23091,15443,7050,31142
45,1091,"Marengo County, Alabama",27975,18323.0,15308,9242,4739,23236
46,1093,"Marion County, Alabama",22486,19030.0,15321,9645,5164,17322
47,1095,"Marshall County, Alabama",25861,19875.0,17089,10793,5439,20422
48,1097,"Mobile County, Alabama",26778,21548.0,17178,11158,6047,20731
49,1099,"Monroe County, Alabama",21885,17652.0,14862,9299,4913,16972
50,1101,"Montgomery County, Alabama",29543,24622.0,19358,12806,6579,22964
51,1103,"Morgan County, Alabama",28474,23090.0,19223,12830,6323,22151
52,1105,"Perry County, Alabama",13833,13433.0,10948,6879,3562,10271
53,1107,"Pickens County, Alabama",23476,16278.0,13746,8564,4451,19025
54,1109,"Pike County, Alabama",23784,19013.0,14904,9423,4503,19281
55,1111,"Randolph County, Alabama",24744,19844.0,14147,9092,4362,20382
56,1113,"Russell County, Alabama",24300,17415.0,14015,9675,4832,19468
57,1115,"St. Clair County, Alabama",27941,22192.0,17960,10596,5617,22324
58,1117,"Shelby County, Alabama",39711,33978.0,27176,16237,6891,32820
59,1119,"Sumter County, Alabama",16977,14460.0,11491,8031,4383,12594
60,1121,"Talladega County, Alabama",24244,18713.0,15704,9700,4981,19263
61,1123,"Tallapoosa County, Alabama",25640,22542.0,16909,10878,5309,20331
62,1125,"Tuscaloosa County, Alabama",27609,22546.0,18998,11406,5684,21925
63,1127,"Walker County, Alabama",25330,20516.0,15546,10105,5524,19806
64,1129,"Washington County, Alabama",30391,18824.0,14081,8340,4578,25813
65,1131,"Wilcox County, Alabama",19031,12573.0,10903,6552,3624,15407
66,1133,"Winston County, Alabama",23269,18055.0,15738,9349,5219,18050
67,4001,"Apache County, Arizona",15781,12294.0,8986,5399,3338,12443
68,4003,"Cochise County, Arizona",28021,23010.0,15988,10716,5738,22283
69,4005,"Coconino County, Arizona",27631,22632.0,17139,10580,5631,22000
70,4007,"Gila County, Arizona",26265,19600.0,16315,10297,5511,20754
71,4009,"Graham County, Arizona",19878,15644.0,12139,8955,4623,15255
72,4011,"Greenlee County, Arizona",27618,21281.0,15814,9794,6567,21051
73,4013,"Maricopa County, Arizona",35090,27816.0,22251,14970,7716,27374
74,4015,"Mohave County, Arizona",27968,21523.0,16788,11933,6673,21295
75,4017,"Navajo County, Arizona",19623,16745.0,11609,7586,4485,15138
76,4019,"Pima County, Arizona",30747,25093.0,19785,13177,7147,23600
77,4021,"Pinal County, Arizona",27354,21716.0,16025,9228,5313,22041
78,4023,"Santa Cruz County, Arizona",21686,16209.0,13278,9007,5447,16239
79,4025,"Yavapai County, Arizona",31779,25527.0,19727,12657,6450,25329
80,4027,"Yuma County, Arizona",23507,18418.0,14802,10428,5681,17826
81,5001,"Arkansas County, Arkansas",26969,22142.0,16401,11169,6054,20915
82,5003,"Ashley County, Arkansas",23138,18779.0,15702,9696,5203,17935
83,5005,"Baxter County, Arkansas",27695,21513.0,16859,10648,5723,21972
84,5007,"Benton County, Arkansas",36597,25186.0,19377,12274,6100,30497
85,5009,"Boone County, Arkansas",24749,20507.0,16175,10129,5434,19315
86,5011,"Bradley County, Arkansas",22912,18845.0,13895,8824,4563,18349
87,5013,"Calhoun County, Arkansas",24823,16457.0,15555,9464,4257,20566
88,5015,"Carroll County, Arkansas",26445,19743.0,16003,10176,5238,21207
89,5017,"Chicot County, Arkansas",21418,14668.0,12825,7452,4091,17327
90,5019,"Clark County, Arkansas",21708,17186.0,14533,9001,5546,16162
91,5021,"Clay County, Arkansas",22935,18892.0,14512,9018,4794,18141
92,5023,"Cleburne County, Arkansas",27490,20371.0,17250,10039,5093,22397
93,5025,"Cleveland County, Arkansas",23998,19481.0,15362,9025,4833,19165
94,5027,"Columbia County, Arkansas",23217,20110.0,15322,9425,5526,17691
95,5029,"Conway County, Arkansas",26539,19909.0,16056,9126,5091,21448
96,5031,"Craighead County, Arkansas",28407,21728.0,17091,11301,5839,22568
97,5033,"Crawford County, Arkansas",25460,18715.0,15015,9689,5166,20294
98,5035,"Crittenden County, Arkansas",24161,18241.0,14424,9334,4942,19219
99,5037,"Cross County, Arkansas",25205,18248.0,15726,8897,5160,20045
100,5039,"Dallas County, Arkansas",21229,16457.0,14610,9101,5547,15682
101,5041,"Desha County, Arkansas",19090,17582.0,13446,8428,5063,14027
102,5043,"Drew County, Arkansas",26440,18903.0,16264,9114,5283,21157
103,5045,"Faulkner County, Arkansas",27414,22811.0,17988,10141,5574,21840
104,5047,"Franklin County, Arkansas",20639,18010.0,14616,8877,4684,15955
105,5049,"Fulton County, Arkansas",20564,17067.0,15712,8240,4272,16292
106,5051,"Garland County, Arkansas",27274,22786.0,18631,11873,6357,20917
107,5053,"Grant County, Arkansas",30639,22229.0,17547,10344,5674,24965
108,5055,"Greene County, Arkansas",23978,18225.0,16403,9757,5143,18835
109,5057,"Hempstead County, Arkansas",22178,17177.0,14103,8583,5095,17083
110,5059,"Hot Spring County, Arkansas",23498,18248.0,15216,9164,5463,18035
111,5061,"Howard County, Arkansas",23297,18216.0,15586,9563,5280,18017
112,5063,"Independence County, Arkansas",25046,19912.0,16163,10493,5092,19954
113,5065,"Izard County, Arkansas",21189,17737.0,14397,8852,4784,16405
114,5067,"Jackson County, Arkansas",19901,14874.0,14564,8984,5197,14704
115,5069,"Jefferson County, Arkansas",21941,18681.0,15417,9852,5476,16465
116,5071,"Johnson County, Arkansas",22077,16937.0,15097,8924,5132,16945
117,5073,"Lafayette County, Arkansas",22204,17699.0,14128,7573,4362,17842
118,5075,"Lawrence County, Arkansas",22113,15168.0,13785,8231,4617,17496
119,5077,"Lee County, Arkansas",20103,13103.0,10983,6582,3447,16656
120,5079,"Lincoln County, Arkansas",14182,15024.0,12479,7899,4157,10025
121,5081,"Little River County, Arkansas",27057,18808.0,15899,9942,5723,21334
122,5083,"Logan County, Arkansas",22632,19121.0,14527,8283,4604,18028
123,5085,"Lonoke County, Arkansas",28446,22473.0,17397,10273,5434,23012
124,5087,"Madison County, Arkansas",22733,18611.0,14736,8548,4381,18352
125,5089,"Marion County, Arkansas",22113,19532.0,14588,9339,4940,17173
126,5091,"Miller County, Arkansas",23828,19654.0,16444,9663,5428,18400
127,5093,"Mississippi County, Arkansas",24825,17736.0,13978,8691,4791,20034
128,5095,"Monroe County, Arkansas",24610,17084.0,13096,7587,4292,20318
129,5097,"Montgomery County, Arkansas",22892,20010.0,14668,8343,4548,18344
130,5099,"Nevada County, Arkansas",19443,21020.0,14184,9666,4976,14467
131,5101,"Newton County, Arkansas",20768,15904.0,13788,7114,3554,17214
132,5103,"Ouachita County, Arkansas",21338,18244.0,15118,9974,5335,16003
133,5105,"Perry County, Arkansas",23030,19844.0,16216,8848,4781,18249
134,5107,"Phillips County, Arkansas",20379,15244.0,12288,6692,4177,16202
135,5109,"Pike County, Arkansas",24642,18122.0,15385,9220,5166,19476
136,5111,"Poinsett County, Arkansas",21154,16625.0,13087,8792,5138,16016
137,5113,"Polk County, Arkansas",24691,16913.0,14063,8884,5238,19453
138,5115,"Pope County, Arkansas",25546,19693.0,15918,10347,5574,19972
139,5117,"Prairie County, Arkansas",26955,18134.0,15907,8642,4900,22055
140,5119,"Pulaski County, Arkansas",33773,27158.0,21466,13760,7134,26639
141,5121,"Randolph County, Arkansas",23534,18751.0,14502,8219,4841,18693
142,5123,"St. Francis County, Arkansas",19743,13693.0,12483,7194,4381,15362
143,5125,"Saline County, Arkansas",31973,24584.0,19214,11677,6416,25557
144,5127,"Scott County, Arkansas",21026,17668.0,13609,8360,4374,16652
145,5129,"Searcy County, Arkansas",19761,15298.0,12536,7209,3765,15996
146,5131,"Sebastian County, Arkansas",28623,22284.0,18424,12361,6834,21789
147,5133,"Sevier County, Arkansas",23423,15590.0,14122,9060,5198,18225
148,5135,"Sharp County, Arkansas",21644,16570.0,14143,8578,4936,16708
149,5137,"Stone County, Arkansas",20462,16090.0,14134,7679,4038,16424
150,5139,"Union County, Arkansas",27129,20447.0,16063,10617,5878,21251
151,5141,"Van Buren County, Arkansas",23244,17999.0,16603,8706,4770,18474
152,5143,"Washington County, Arkansas",29419,22421.0,17347,11625,5852,23567
153,5145,"White County, Arkansas",23801,20900.0,15890,9902,4860,18941
154,5147,"Woodruff County, Arkansas",25677,18344.0,13269,7583,4572,21105
155,5149,"Yell County, Arkansas",23008,16345.0,15383,9400,4801,18207
156,6001,"Alameda County, California",49883,33961.0,26680,17547,8537,41346
157,6003,"Alpine County, California",37690,32159.0,24431,13799,7669,30021
158,6005,"Amador County, California",33897,26329.0,22412,14282,6988,26909
159,6007,"Butte County, California",30700,23404.0,17517,12083,6708,23992
160,6009,"Calaveras County, California",33027,28408.0,21420,13497,7152,25875
161,6011,"Colusa County, California",27614,21317.0,14730,12402,7280,20334
162,6013,"Contra Costa County, California",50118,37818.0,30615,20748,9823,40295
163,6015,"Del Norte County, California",24361,18974.0,14573,10625,6287,18074
164,6017,"El Dorado County, California",44651,34393.0,25560,15703,7968,36683
165,6019,"Fresno County, California",25757,20329.0,15495,11824,6967,18790
166,6021,"Glenn County, California",23715,19987.0,14069,10677,6534,17181
167,6023,"Humboldt County, California",29584,24025.0,17203,12436,6890,22694
168,6025,"Imperial County, California",18064,16395.0,13239,9208,5809,12255
169,6027,"Inyo County, California",33404,26762.0,19639,13397,6987,26417
170,6029,"Kern County, California",23855,20100.0,15760,12154,6990,16865
171,6031,"Kings County, California",22919,17875.0,15848,10035,5843,17076
172,6033,"Lake County, California",29714,21531.0,16825,11705,6292,23422
173,6035,"Lassen County, California",20928,19756.0,14749,12626,6406,14522
174,6037,"Los Angeles County, California",35685,27344.0,20683,16149,8303,27382
175,6039,"Madera County, California",23212,18724.0,14682,10856,6361,16851
176,6041,"Marin County, California",74446,53940.0,44962,28381,12332,62114
177,6043,"Mariposa County, California",29882,27064.0,18190,13074,6676,23206
178,6045,"Mendocino County, California",30351,23357.0,19443,12776,6809,23542
179,6047,"Merced County, California",23677,18041.0,14257,10606,6267,17410
180,6049,"Modoc County, California",25578,20536.0,17285,10971,6563,19015
181,6051,"Mono County, California",37103,27321.0,23422,16120,8590,28513
182,6053,"Monterey County, California",32122,25776.0,20165,14578,7495,24627
183,6055,"Napa County, California",46912,34310.0,26395,17640,8503,38409
184,6057,"Nevada County, California",41079,30727.0,24007,15760,7505,33574
185,6059,"Orange County, California",43049,34017.0,25826,19890,9567,33482
186,6061,"Placer County, California",46023,35680.0,27963,17311,8167,37856
187,6063,"Plumas County, California",34334,28732.0,19391,12952,6857,27477
188,6065,"Riverside County, California",29913,24431.0,18689,14510,7476,22437
189,6067,"Sacramento County, California",34078,26953.0,21142,15265,7950,26128
190,6069,"San Benito County, California",33841,25508.0,20932,13933,6208,27633
191,6071,"San Bernardino County, California",26402,21867.0,16856,13358,7090,19312
192,6073,"San Diego County, California",39737,30715.0,22926,16220,7960,31777
193,6075,"San Francisco County, California",72041,45478.0,34556,19695,9265,62776
194,6077,"San Joaquin County, California",28928,22851.0,17365,12705,7016,21912
195,6079,"San Luis Obispo County, California",38686,29790.0,21864,15237,7048,31638
196,6081,"San Mateo County, California",64450,43958.0,36045,22430,10666,53784
197,6083,"Santa Barbara County, California",38141,29731.0,23059,17155,8406,29735
198,6085,"Santa Clara County, California",59297,39804.0,32795,20423,9518,49779
199,6087,"Santa Cruz County, California",44278,32862.0,26396,17347,8197,36081
200,6089,"Shasta County, California",31049,23772.0,17738,12381,6791,24258
201,6091,"Sierra County, California",32533,27389.0,18815,13731,7120,25413
202,6093,"Siskiyou County, California",29381,22179.0,17570,11610,6535,22846
203,6095,"Solano County, California",36685,28649.0,21731,14833,7407,29278
204,6097,"Sonoma County, California",44071,32597.0,25724,17239,8091,35980
205,6099,"Stanislaus County, California",27225,22064.0,16913,12731,7094,20131
206,6101,"Sutter County, California",29495,22344.0,17428,12763,7108,22387
207,6103,"Tehama County, California",29012,20198.0,15793,10990,6137,22875
208,6105,"Trinity County, California",26228,22073.0,16868,10781,6295,19933
209,6107,"Tulare County, California",22092,17966.0,14006,10302,6038,16054
210,6109,"Tuolumne County, California",35694,25483.0,21015,13224,6745,28949
211,6111,"Ventura County, California",39403,32348.0,24600,17861,8015,31388
212,6113,"Yolo County, California",36036,27420.0,19365,13861,7277,28759
213,6115,"Yuba County, California",25774,19937.0,14124,9874,5539,20235
214,8001,"Adams County, Colorado",31310,23999.0,19944,12615,7259,24051
215,8003,"Alamosa County, Colorado",23020,18820.0,15037,9286,5694,17326
216,8005,"Arapahoe County, Colorado",42184,31898.0,28147,18777,10192,31992
217,8007,"Archuleta County, Colorado",32995,25421.0,21683,10913,5550,27445
218,8009,"Baca County, Colorado",24583,21472.0,15068,9571,5607,18976
219,8011,"Bent County, Colorado",15738,16505.0,13567,9170,5811,9927
220,8013,"Boulder County, Colorado",48776,36947.0,28976,17359,8607,40169
221,8015,"Chaffee County, Colorado",31960,26110.0,19430,10788,6244,25716
222,8017,"Cheyenne County, Colorado",31409,22999.0,17850,11382,5663,25746
223,8019,"Clear Creek County, Colorado",44162,34506.0,28160,16196,9393,34769
224,8021,"Conejos County, Colorado",20139,17541.0,12050,6664,3285,16854
225,8023,"Costilla County, Colorado",21893,16525.0,10748,7057,3680,18213
226,8025,"Crowley County, Colorado",16593,18966.0,12836,6978,4675,11918
227,8027,"Custer County, Colorado",31608,26860.0,19817,11309,5331,26277
228,8029,"Delta County, Colorado",26642,22080.0,17152,9586,5519,21123
229,8031,"Denver County, Colorado",45636,30806.0,24101,15590,8555,37081
230,8033,"Dolores County, Colorado",31290,19244.0,17106,9784,5381,25909
231,8035,"Douglas County, Colorado",53836,42418.0,34848,21002,10522,43314
232,8037,"Eagle County, Colorado",47406,36753.0,32011,18202,9888,37518
233,8039,"Elbert County, Colorado",43911,34782.0,24960,14566,6940,36971
234,8041,"El Paso County, Colorado",35177,27945.0,22005,13664,7027,28150
235,8043,"Fremont County, Colorado",24703,19083.0,17420,9971,5901,18802
236,8045,"Garfield County, Colorado",33826,28457.0,21341,13086,7704,26122
237,8047,"Gilpin County, Colorado",59076,33591.0,26148,15267,7920,51156
238,8049,"Grand County, Colorado",39547,30055.0,25198,13457,7768,31779
239,8051,"Gunnison County, Colorado",33727,28490.0,21407,11516,6630,27097
240,8053,"Hinsdale County, Colorado",34595,43293.0,22360,12978,7806,26789
241,8055,"Huerfano County, Colorado",25839,23139.0,15242,8212,5159,20680
242,8057,"Jackson County, Colorado",30813,23814.0,17826,10858,6864,23949
243,8059,"Jefferson County, Colorado",45581,34714.0,28066,17310,9469,36112
244,8061,"Kiowa County, Colorado",23275,22877.0,16382,10305,6452,16823
245,8063,"Kit Carson County, Colorado",29276,21086.0,16964,11385,5950,23326
246,8065,"Lake County, Colorado",35264,20437.0,18524,11269,7733,27531
247,8067,"La Plata County, Colorado",38841,29836.0,21534,12163,6728,32113
248,8069,"Larimer County, Colorado",38142,30046.0,23689,13968,7458,30684
249,8071,"Las Animas County, Colorado",26918,21887.0,16829,8934,5110,21808
250,8073,"Lincoln County, Colorado",16755,23440.0,15510,10052,6357,10398
251,8075,"Logan County, Colorado",26281,22564.0,16721,10899,6600,19681
252,8077,"Mesa County, Colorado",29783,27067.0,18715,11850,7167,22616
253,8079,"Mineral County, Colorado",30908,46358.0,24475,11082,7104,23804
254,8081,"Moffat County, Colorado",29059,24563.0,18540,12354,8003,21056
255,8083,"Montezuma County, Colorado",26564,24616.0,17003,10176,5963,20601
256,8085,"Montrose County, Colorado",30017,23613.0,17158,11092,6379,23638
257,8087,"Morgan County, Colorado",24800,20181.0,15492,10928,6431,18369
258,8089,"Otero County, Colorado",23275,18056.0,15113,9573,5123,18152
259,8091,"Ouray County, Colorado",41481,29051.0,24335,13208,6770,34711
260,8093,"Park County, Colorado",38042,31663.0,25019,14325,7095,30947
261,8095,"Phillips County, Colorado",29857,23453.0,16394,10444,6325,23532
262,8097,"Pitkin County, Colorado",61261,64381.0,40811,26755,12054,49207
263,8099,"Prowers County, Colorado",23496,18429.0,14150,9662,5641,17855
264,8101,"Pueblo County, Colorado",26504,21609.0,17163,10347,6669,19835
265,8103,"Rio Blanco County, Colorado",28287,28382.0,17344,12357,7679,20608
266,8105,"Rio Grande County, Colorado",27300,17199.0,15650,9582,5448,21852
267,8107,"Routt County, Colorado",44727,33079.0,28792,15429,8972,35755
268,8109,"Saguache County, Colorado",22921,18686.0,13121,8630,4504,18417
269,8111,"San Juan County, Colorado",36454,31232.0,17584,11029,6061,30393
270,8113,"San Miguel County, Colorado",47248,38247.0,35329,16454,6346,40902
271,8115,"Sedgwick County, Colorado",27961,21652.0,16125,9901,5913,22048
272,8117,"Summit County, Colorado",44973,35770.0,28676,17400,10152,34821
273,8119,"Teller County, Colorado",34541,28726.0,23412,13698,7052,27489
274,8121,"Washington County, Colorado",28224,23125.0,17788,10473,5754,22470
275,8123,"Weld County, Colorado",32399,24732.0,18957,11350,6505,25894
276,8125,"Yuma County, Colorado",28791,21872.0,16005,10713,5958,22833
277,9001,"Fairfield County, Connecticut",58851,48295.0,38350,26161,10408,48443
278,9003,"Hartford County, Connecticut",41470,33151.0,26047,18983,8342,33128
279,9005,"Litchfield County, Connecticut",45702,35848.0,28408,19971,8181,37521
280,9007,"Middlesex County, Connecticut",46846,37519.0,28251,19660,8036,38810
281,9009,"New Haven County, Connecticut",39134,31720.0,24439,17666,7609,31525
282,9011,"New London County, Connecticut",40995,32888.0,24678,16702,7307,33688
283,9013,"Tolland County, Connecticut",41537,33108.0,25474,17849,7506,34031
284,9015,"Windham County, Connecticut",33337,26457.0,20443,14520,6419,26918
285,10001,"Kent County, Delaware",28911,24194.0,18662,12726,6126,22785
286,10003,"New Castle County, Delaware",38965,31220.0,25413,17442,8067,30898
287,10005,"Sussex County, Delaware",36739,26779.0,20328,12723,6262,30477
288,11001,"District Of Columbia, District Of Columbia",58659,42078.0,28659,18881,8960,49699
289,12001,"Alachua County, Florida",29821,24741.0,18465,12252,6094,23727
290,12003,"Baker County, Florida",24051,19593.0,15164,9417,4727,19324
291,12005,"Bay County, Florida",30774,25033.0,18700,12225,5968,24806
292,12007,"Bradford County, Florida",21003,16997.0,14226,10287,4813,16190
293,12009,"Brevard County, Florida",33662,27606.0,21484,15093,7448,26214
294,12011,"Broward County, Florida",34063,28631.0,23170,16883,8624,25439
295,12013,"Calhoun County, Florida",19512,15091.0,12379,8867,4710,14802
296,12015,"Charlotte County, Florida",33275,26938.0,21806,14431,7547,25728
297,12017,"Citrus County, Florida",28174,22551.0,18585,12151,6055,22119
298,12019,"Clay County, Florida",32037,26872.0,20868,13945,6741,25296
299,12021,"Collier County, Florida",46785,37046.0,31195,21386,9424,37361
300,12023,"Columbia County, Florida",24569,19366.0,14598,10324,5702,18867
301,12027,"De Soto County, Florida",18193,15989.0,14000,10286,4913,13280
302,12029,"Dixie County, Florida",19911,17066.0,13559,8527,4690,15221
303,12031,"Duval County, Florida",32233,25854.0,20753,13857,6822,25411
304,12033,"Escambia County, Florida",29166,23474.0,18641,12161,6183,22983
305,12035,"Flagler County, Florida",32722,24939.0,21879,15124,6920,25802
306,12037,"Franklin County, Florida",26211,21005.0,16140,9954,4653,21558
307,12039,"Gadsden County, Florida",21087,16843.0,14499,8597,4175,16912
308,12041,"Gilchrist County, Florida",22775,18309.0,13985,9690,4804,17971
309,12043,"Glades County, Florida",22128,17872.0,15338,10719,4615,17513
310,12045,"Gulf County, Florida",27626,17968.0,14449,10028,4932,22694
311,12047,"Hamilton County, Florida",15532,15794.0,10562,8851,4350,11182
312,12049,"Hardee County, Florida",20181,14668.0,12445,9411,5120,15061
313,12051,"Hendry County, Florida",20122,14734.0,13663,10035,5738,14384
314,12053,"Hernando County, Florida",26520,22775.0,18321,11864,5881,20639
315,12055,"Highlands County, Florida",27979,19579.0,17222,12112,5964,22015
316,12057,"Hillsborough County, Florida",33616,27062.0,21812,14203,6752,26864
317,12059,"Holmes County, Florida",19028,15285.0,14135,8609,4741,14287
318,12061,"Indian River County, Florida",38274,31918.0,27227,17825,8098,30176
319,12063,"Jackson County, Florida",21058,17177.0,13905,9654,4815,16243
320,12065,"Jefferson County, Florida",25795,19647.0,17006,9744,4570,21225
321,12067,"Lafayette County, Florida",17022,18069.0,13087,8966,4934,12088
322,12069,"Lake County, Florida",29426,25323.0,20199,12450,6449,22977
323,12071,"Lee County, Florida",34818,29445.0,24542,15623,7554,27264
324,12073,"Leon County, Florida",31778,25803.0,21024,14088,6862,24916
325,12075,"Levy County, Florida",22772,18703.0,14746,9386,5100,17672
326,12077,"Liberty County, Florida",19585,17003.0,17225,11500,4730,14855
327,12079,"Madison County, Florida",18909,16346.0,12511,9727,4205,14704
328,12081,"Manatee County, Florida",35146,28072.0,22388,14444,7206,27940
329,12083,"Marion County, Florida",26990,22384.0,17848,11782,5813,21177
330,12085,"Martin County, Florida",43758,35772.0,29584,20328,8099,35659
331,12087,"Monroe County, Florida",47382,35516.0,26102,18869,7755,39627
332,12089,"Nassau County, Florida",37787,29089.0,22836,13288,6416,31371
333,12091,"Okaloosa County, Florida",34357,28621.0,20918,13147,6422,27935
334,12093,"Okeechobee County, Florida",23133,19664.0,14553,9792,5478,17655
335,12095,"Orange County, Florida",31409,25490.0,20916,14570,6984,24425
336,12097,"Osceola County, Florida",24146,20536.0,17022,12268,6055,18091
337,12099,"Palm Beach County, Florida",40957,33610.0,28801,19937,8903,32054
338,12101,"Pasco County, Florida",29498,24164.0,18439,11732,6063,23435
339,12103,"Pinellas County, Florida",36754,28742.0,23497,15712,7623,29131
340,12105,"Polk County, Florida",25820,21881.0,18302,12392,6460,19360
341,12107,"Putnam County, Florida",22257,18402.0,15603,10079,5481,16776
342,12109,"St. Johns County, Florida",43433,36027.0,28674,17113,6718,36715
343,12111,"St. Lucie County, Florida",28426,23296.0,18790,13387,6477,21949
344,12113,"Santa Rosa County, Florida",32322,25384.0,20089,12656,6057,26265
345,12115,"Sarasota County, Florida",44402,33045.0,28326,18441,8449,35953
346,12117,"Seminole County, Florida",36016,29795.0,24591,16644,7676,28340
347,12119,"Sumter County, Florida",35879,24180.0,16830,9920,5157,30722
348,12121,"Suwannee County, Florida",23389,18782.0,14678,9768,4908,18481
349,12123,"Taylor County, Florida",19492,18649.0,15281,10331,5718,13774
350,12125,"Union County, Florida",20663,13657.0,12333,9648,3703,16960
351,12127,"Volusia County, Florida",29859,24768.0,19664,13288,6588,23271
352,12129,"Wakulla County, Florida",28320,21892.0,17678,10858,5111,23209
353,12131,"Walton County, Florida",35996,27746.0,18198,11290,5218,30778
354,12133,"Washington County, Florida",19375,18470.0,14980,8794,4526,14849
355,13001,"Appling County, Georgia",21675,18977.0,15044,9901,4544,17131
356,13003,"Atkinson County, Georgia",20887,15456.0,12178,7902,3965,16922
357,13005,"Bacon County, Georgia",19882,17110.0,14289,9137,4608,15274
358,13007,"Baker County, Georgia",25691,16379.0,16969,8667,4431,21260
359,13009,"Baldwin County, Georgia",26934,17488.0,16271,10358,5704,21230
360,13011,"Banks County, Georgia",24303,19497.0,17424,10741,5497,18806
361,13013,"Barrow County, Georgia",25849,20882.0,18350,11156,5554,20295
362,13015,"Bartow County, Georgia",27047,22241.0,18989,11748,5702,21345
363,13017,"Ben Hill County, Georgia",18241,15529.0,14093,9300,5083,13158
364,13019,"Berrien County, Georgia",20545,16049.0,16375,9403,5113,15432
365,13021,"Bibb County, Georgia",25519,21436.0,19058,13017,6137,19382
366,13023,"Bleckley County, Georgia",20502,18960.0,15934,10775,5520,14982
367,13025,"Brantley County, Georgia",18883,18905.0,13713,9089,4524,14359
368,13027,"Brooks County, Georgia",26115,20346.0,13977,8522,4152,21963
369,13029,"Bryan County, Georgia",32825,28365.0,19794,11083,4883,27942
370,13031,"Bulloch County, Georgia",25121,17812.0,16080,9635,5206,19915
371,13033,"Burke County, Georgia",24050,15934.0,13136,8185,4493,19557
372,13035,"Butts County, Georgia",25343,20963.0,17016,10321,5363,19980
373,13037,"Calhoun County, Georgia",15461,12452.0,11839,8244,4072,11389
374,13039,"Camden County, Georgia",29449,22022.0,16445,11710,5404,24045
375,13043,"Candler County, Georgia",20897,16068.0,12958,9293,4713,16184
376,13045,"Carroll County, Georgia",26495,20523.0,17656,11239,5536,20959
377,13047,"Catoosa County, Georgia",28537,22563.0,18009,11059,5919,22618
378,13049,"Charlton County, Georgia",19228,16652.0,12920,8894,4620,14608
379,13051,"Chatham County, Georgia",33106,25397.0,21152,12983,6385,26721
380,13053,"Chattahoochee County, Georgia",23894,22202.0,14049,8673,4817,19077
381,13055,"Chattooga County, Georgia",18523,15158.0,14508,9281,5105,13418
382,13057,"Cherokee County, Georgia",38153,30217.0,24871,14849,6341,31812
383,13059,"Clarke County, Georgia",25343,19839.0,17123,11604,6192,19151
384,13061,"Clay County, Georgia",22389,13353.0,16819,7678,4084,18305
385,13063,"Clayton County, Georgia",21804,18958.0,18079,13577,7308,14496
386,13065,"Clinch County, Georgia",17539,16709.0,13023,8354,4523,13016
387,13067,"Cobb County, Georgia",41480,33110.0,27863,19166,8673,32807
388,13069,"Coffee County, Georgia",20659,16664.0,15530,10170,4615,16044
389,13071,"Colquitt County, Georgia",20530,17362.0,14457,9878,5149,15381
390,13073,"Columbia County, Georgia",35349,29479.0,23496,15372,6739,28610
391,13075,"Cook County, Georgia",20769,16528.0,13465,8870,4789,15980
392,13077,"Coweta County, Georgia",36884,26161.0,21949,13708,6324,30560
393,13079,"Crawford County, Georgia",24404,20692.0,15768,10003,5703,18701
394,13081,"Crisp County, Georgia",25402,17187.0,14695,9248,5217,20185
395,13083,"Dade County, Georgia",24964,20168.0,16127,9360,5003,19961
396,13085,"Dawson County, Georgia",36110,25557.0,22520,12198,5084,31026
397,13087,"Decatur County, Georgia",21810,17833.0,15063,9246,4945,16865
398,13089,"De Kalb County, Georgia",37523,28412.0,23968,17115,8443,29080
399,13091,"Dodge County, Georgia",21144,16288.0,14468,8643,4616,16528
400,13093,"Dooly County, Georgia",25198,14871.0,13628,8413,4182,21016
401,13095,"Dougherty County, Georgia",22647,19210.0,16645,10888,5988,16659
402,13097,"Douglas County, Georgia",29083,24515.0,21172,14096,6520,22563
403,13099,"Early County, Georgia",21992,16330.0,14936,8280,4684,17308
404,13101,"Echols County, Georgia",23768,14201.0,15727,8915,4273,19495
405,13103,"Effingham County, Georgia",32608,23465.0,18873,10865,5425,27183
406,13105,"Elbert County, Georgia",23368,17100.0,14535,9288,5023,18345
407,13107,"Emanuel County, Georgia",19310,16076.0,13627,8535,4755,14555
408,13109,"Evans County, Georgia",20990,19072.0,12758,9792,4664,16326
409,13111,"Fannin County, Georgia",29845,21103.0,16269,9430,4670,25175
410,13113,"Fayette County, Georgia",44668,35076.0,29464,19025,8782,35886
411,13115,"Floyd County, Georgia",27418,20640.0,17808,12121,6218,21200
412,13117,"Forsyth County, Georgia",46470,35385.0,29114,15763,6656,39814
413,13119,"Franklin County, Georgia",24338,19276.0,15767,10390,4968,19370
414,13121,"Fulton County, Georgia",49369,37211.0,30003,18452,7621,41748
415,13123,"Gilmer County, Georgia",27789,20439.0,17147,9676,4932,22857
416,13125,"Glascock County, Georgia",24258,16844.0,14185,9585,5390,18868
417,13127,"Glynn County, Georgia",33975,28040.0,21707,14055,6840,27135
418,13129,"Gordon County, Georgia",25114,18285.0,17586,11587,5571,19543
419,13131,"Grady County, Georgia",24272,17785.0,14278,9200,4418,19854
420,13133,"Greene County, Georgia",42339,24943.0,23389,9390,4308,38031
421,13135,"Gwinnett County, Georgia",31935,26901.0,25006,17881,8167,23768
422,13137,"Habersham County, Georgia",24060,19286.0,17706,10950,5371,18689
423,13139,"Hall County, Georgia",30459,23675.0,19690,13356,6469,23990
424,13141,"Hancock County, Georgia",17802,10925.0,10916,7345,3776,14026
425,13143,"Haralson County, Georgia",27507,19033.0,15823,9939,5426,22081
426,13145,"Harris County, Georgia",37882,31073.0,21680,13135,6206,31676
427,13147,"Hart County, Georgia",24443,19124.0,16714,11187,5056,19387
428,13149,"Heard County, Georgia",23498,18077.0,15132,9218,5223,18275
429,13151,"Henry County, Georgia",31173,25773.0,22945,14167,6857,24316
430,13153,"Houston County, Georgia",30616,25206.0,19515,12939,6729,23887
431,13155,"Irwin County, Georgia",21123,16561.0,14867,10057,4814,16309
432,13157,"Jackson County, Georgia",29724,22473.0,17808,10885,5401,24323
433,13159,"Jasper County, Georgia",24270,20263.0,19249,10761,5389,18881
434,13161,"Jeff Davis County, Georgia",18452,15730.0,13780,9632,5092,13360
435,13163,"Jefferson County, Georgia",21178,15165.0,13491,8317,4183,16995
436,13165,"Jenkins County, Georgia",14212,17629.0,13400,8391,4112,10100
437,13167,"Johnson County, Georgia",21093,15659.0,12384,8550,4779,16314
438,13169,"Jones County, Georgia",27555,21598.0,19126,13543,6391,21164
439,13171,"Lamar County, Georgia",24576,17725.0,16666,10198,5258,19318
440,13173,"Lanier County, Georgia",18788,16894.0,13690,8319,4078,14710
441,13175,"Laurens County, Georgia",23694,19387.0,16763,10423,5359,18335
442,13177,"Lee County, Georgia",29379,23867.0,19897,11106,6363,23016
443,13179,"Liberty County, Georgia",24121,18662.0,13855,8986,4910,19211
444,13181,"Lincoln County, Georgia",24074,19627.0,15351,9628,5352,18722
445,13183,"Long County, Georgia",22553,15068.0,12586,8815,4513,18040
446,13185,"Lowndes County, Georgia",24580,20041.0,16683,10919,5609,18971
447,13187,"Lumpkin County, Georgia",29361,20088.0,18062,10814,5384,23977
448,13189,"Mcduffie County, Georgia",23355,17261.0,18005,10274,5166,18189
449,13191,"Mcintosh County, Georgia",28352,20964.0,14253,8878,4260,24092
450,13193,"Macon County, Georgia",20198,12902.0,11820,8101,4306,15892
451,13195,"Madison County, Georgia",24772,18975.0,16998,10997,5266,19506
452,13197,"Marion County, Georgia",23617,17729.0,14044,9779,3933,19684
453,13199,"Meriwether County, Georgia",22905,18295.0,15708,8660,4907,17998
454,13201,"Miller County, Georgia",24492,19895.0,15435,11096,4557,19935
455,13205,"Mitchell County, Georgia",19377,16322.0,13042,8327,4736,14641
456,13207,"Monroe County, Georgia",34630,23656.0,19580,11348,5401,29229
457,13209,"Montgomery County, Georgia",23744,17168.0,14182,9283,4381,19363
458,13211,"Morgan County, Georgia",34205,27732.0,18823,10713,5046,29159
459,13213,"Murray County, Georgia",23208,16925.0,16230,10575,5580,17628
460,13215,"Muscogee County, Georgia",26709,22514.0,18262,11949,6044,20665
461,13217,"Newton County, Georgia",25394,21583.0,19317,11641,5689,19705
462,13219,"Oconee County, Georgia",49099,34271.0,24153,15164,6708,42391
463,13221,"Oglethorpe County, Georgia",25884,17572.0,17089,10064,5046,20838
464,13223,"Paulding County, Georgia",29766,23450.0,19974,12322,5650,24116
465,13225,"Peach County, Georgia",25929,18681.0,16031,10989,5337,20592
466,13227,"Pickens County, Georgia",32501,25892.0,19774,11442,5474,27027
467,13229,"Pierce County, Georgia",23832,18283.0,14230,9858,4596,19236
468,13231,"Pike County, Georgia",29024,21051.0,17661,11593,5629,23395
469,13233,"Polk County, Georgia",24258,18214.0,15617,10184,5397,18861
470,13235,"Pulaski County, Georgia",20693,16621.0,16435,11265,5063,15630
471,13237,"Putnam County, Georgia",34294,25576.0,20161,11951,5421,28873
472,13239,"Quitman County, Georgia",22827,13642.0,14301,8820,3664,19163
473,13241,"Rabun County, Georgia",30875,22471.0,20608,11161,5469,25406
474,13243,"Randolph County, Georgia",15931,17632.0,11809,6991,4669,11262
475,13245,"Richmond County, Georgia",23842,20604.0,17088,11799,5873,17969
476,13247,"Rockdale County, Georgia",29098,24367.0,22300,15710,7102,21996
477,13249,"Schley County, Georgia",21857,16122.0,14981,9747,4516,17341
478,13251,"Screven County, Georgia",23912,16189.0,13894,9269,4500,19412
479,13253,"Seminole County, Georgia",28132,19263.0,14635,9270,4837,23295
480,13255,"Spalding County, Georgia",30491,19607.0,16791,11073,5758,24733
481,13257,"Stephens County, Georgia",22975,18285.0,15529,10531,5565,17410
482,13259,"Stewart County, Georgia",17244,15612.0,16071,7772,3517,13727
483,13261,"Sumter County, Georgia",21927,17436.0,15083,9600,5005,16922
484,13263,"Talbot County, Georgia",23687,18007.0,14539,8728,4784,18903
485,13265,"Taliaferro County, Georgia",20979,13955.0,15498,7624,4082,16897
486,13267,"Tattnall County, Georgia",19245,16742.0,13439,9286,4110,15135
487,13269,"Taylor County, Georgia",21770,14693.0,13432,9182,5345,16425
488,13271,"Telfair County, Georgia",17518,13420.0,14197,8452,4605,12913
489,13273,"Terrell County, Georgia",19987,15553.0,13894,8524,4539,15448
490,13275,"Thomas County, Georgia",27937,21261.0,16211,10293,5248,22689
491,13277,"Tift County, Georgia",24191,18394.0,16833,10612,5330,18861
492,13279,"Toombs County, Georgia",24797,17974.0,14252,9775,4808,19989
493,13281,"Towns County, Georgia",27763,21527.0,18221,10777,5106,22657
494,13283,"Treutlen County, Georgia",24390,16710.0,13122,7865,4840,19550
495,13285,"Troup County, Georgia",24660,19699.0,17626,11581,5707,18953
496,13287,"Turner County, Georgia",19653,15973.0,13454,7953,4696,14957
497,13289,"Twiggs County, Georgia",22534,15904.0,14259,8510,4485,18049
498,13291,"Union County, Georgia",30885,24182.0,18845,10975,4408,26477
499,13293,"Upson County, Georgia",22423,17398.0,17053,10554,5615,16808
500,13295,"Walker County, Georgia",25157,19440.0,15867,10575,5671,19486
501,13297,"Walton County, Georgia",28436,22521.0,19470,11932,5412,23024
502,13299,"Ware County, Georgia",20221,18295.0,14384,9712,5388,14833
503,13301,"Warren County, Georgia",24547,15987.0,14022,7864,4257,20290
504,13303,"Washington County, Georgia",20535,15033.0,15565,9917,4883,15652
505,13305,"Wayne County, Georgia",21763,18393.0,15628,9856,5423,16340
506,13307,"Webster County, Georgia",22034,16295.0,14772,9202,4492,17542
507,13309,"Wheeler County, Georgia",15186,10043.0,13005,9522,3854,11332
508,13311,"White County, Georgia",28340,23680.0,17193,11277,5652,22688
509,13313,"Whitfield County, Georgia",24361,19780.0,18515,13324,6579,17782
510,13315,"Wilcox County, Georgia",16471,12692.0,14014,8733,4679,11792
511,13317,"Wilkes County, Georgia",23265,16993.0,15020,10752,5247,18018
512,13319,"Wilkinson County, Georgia",22987,17929.0,14658,10415,5206,17781
513,13321,"Worth County, Georgia",26533,18348.0,15856,9469,5113,21420
514,16001,"Ada County, Idaho",37333,27915.0,22519,14268,7749,29584
515,16003,"Adams County, Idaho",30136,22730.0,14908,13732,5873,24263
516,16005,"Bannock County, Idaho",25044,21275.0,17148,10976,6692,18352
517,16007,"Bear Lake County, Idaho",27596,19284.0,13592,8989,5442,22154
518,16009,"Benewah County, Idaho",24737,18312.0,15285,9921,6484,18253
519,16011,"Bingham County, Idaho",24947,18633.0,14365,9474,5155,19792
520,16013,"Blaine County, Idaho",36232,32656.0,31346,19979,7992,28240
521,16015,"Boise County, Idaho",33384,24288.0,18787,11747,6308,27076
522,16017,"Bonner County, Idaho",28527,24745.0,17263,10527,5315,23212
523,16019,"Bonneville County, Idaho",28171,23218.0,18326,12123,6568,21603
524,16021,"Boundary County, Idaho",26796,18011.0,14636,9054,4958,21838
525,16023,"Butte County, Idaho",31659,20414.0,14948,10257,5484,26175
526,16025,"Camas County, Idaho",31291,19659.0,19550,11373,5861,25430
527,16027,"Canyon County, Idaho",23919,18366.0,15155,9916,5761,18158
528,16029,"Caribou County, Idaho",26640,20637.0,15179,10808,5798,20842
529,16031,"Cassia County, Idaho",23406,17782.0,14087,9726,5245,18161
530,16033,"Clark County, Idaho",20733,19737.0,11141,10608,4591,16142
531,16035,"Clearwater County, Idaho",25357,20507.0,15463,11234,6612,18745
532,16037,"Custer County, Idaho",24082,22625.0,15783,11607,5237,18845
533,16039,"Elmore County, Idaho",23772,20388.0,16773,9981,5324,18448
534,16041,"Franklin County, Idaho",25825,17967.0,13702,8532,4771,21054
535,16043,"Fremont County, Idaho",23970,18616.0,13965,8674,4724,19246
536,16045,"Gem County, Idaho",26671,20431.0,15340,10450,5801,20870
537,16047,"Gooding County, Idaho",24388,17694.0,14612,9625,5353,19035
538,16049,"Idaho County, Idaho",24811,18980.0,14411,10527,5873,18938
539,16051,"Jefferson County, Idaho",25639,19019.0,13838,9055,4577,21062
540,16053,"Jerome County, Idaho",23417,16947.0,15530,9727,5638,17779
541,16055,"Kootenai County, Idaho",30912,24418.0,18430,12330,6346,24566
542,16057,"Latah County, Idaho",27644,20218.0,16690,10892,6441,21203
543,16059,"Lemhi County, Idaho",25417,21699.0,16037,10624,5565,19852
544,16061,"Lewis County, Idaho",24994,18580.0,15942,9780,5782,19212
545,16063,"Lincoln County, Idaho",22250,19011.0,14257,9339,4853,17397
546,16065,"Madison County, Idaho",21943,13735.0,10956,7385,4098,17845
547,16067,"Minidoka County, Idaho",24423,17747.0,13813,10110,5368,19055
548,16069,"Nez Perce County, Idaho",30103,23899.0,18544,12476,6990,23113
549,16071,"Oneida County, Idaho",24294,17950.0,13829,8824,4353,19941
550,16073,"Owyhee County, Idaho",23798,17373.0,13405,9786,4377,19421
551,16075,"Payette County, Idaho",26028,18814.0,14924,9400,5074,20954
552,16077,"Power County, Idaho",24775,18412.0,14007,9951,5971,18804
553,16079,"Shoshone County, Idaho",24564,19020.0,15934,10373,6531,18033
554,16081,"Teton County, Idaho",34905,23633.0,17778,8983,4297,30608
555,16083,"Twin Falls County, Idaho",27018,19892.0,16678,11096,6405,20613
556,16085,"Valley County, Idaho",31192,27577.0,19246,12344,6615,24577
557,16087,"Washington County, Idaho",24216,20015.0,15464,9088,5112,19104
558,17001,"Adams County, Illinois",31035,24308.0,17894,11601,6667,24368
559,17003,"Alexander County, Illinois",20450,15858.0,16084,8846,4987,15463
560,17005,"Bond County, Illinois",27274,24341.0,17947,10407,6376,20898
561,17007,"Boone County, Illinois",32659,26105.0,21590,14355,7555,25104
562,17009,"Brown County, Illinois",22835,17133.0,14629,8894,5705,17130
563,17011,"Bureau County, Illinois",29700,24103.0,19542,11915,7408,22292
564,17013,"Calhoun County, Illinois",30282,23109.0,16785,9815,5606,24676
565,17015,"Carroll County, Illinois",30090,25914.0,18688,12358,6785,23305
566,17017,"Cass County, Illinois",26747,19825.0,16532,10850,6809,19938
567,17019,"Champaign County, Illinois",31254,24553.0,19708,13130,7311,23943
568,17021,"Christian County, Illinois",28959,21519.0,17937,11676,6998,21961
569,17023,"Clark County, Illinois",30649,23173.0,17655,11176,6655,23994
570,17025,"Clay County, Illinois",29950,20802.0,15771,9590,5592,24358
571,17027,"Clinton County, Illinois",33231,25392.0,19109,11422,6263,26968
572,17029,"Coles County, Illinois",28495,20601.0,17370,11315,6686,21809
573,17031,"Cook County, Illinois",39239,29335.0,23227,15697,8229,31010
574,17033,"Crawford County, Illinois",27211,21545.0,16869,11768,7020,20191
575,17035,"Cumberland County, Illinois",29426,21262.0,16953,10486,6174,23252
576,17037,"De Kalb County, Illinois",29780,24179.0,19462,12657,7214,22566
577,17039,"De Witt County, Illinois",30910,24320.0,20488,12833,7528,23382
578,17041,"Douglas County, Illinois",28603,21438.0,18474,11461,7397,21206
579,17043,"Du Page County, Illinois",47501,37849.0,31315,21155,10473,37028
580,17045,"Edgar County, Illinois",27775,22175.0,17857,11190,6564,21211
581,17047,"Edwards County, Illinois",27847,21113.0,16187,10713,6289,21558
582,17049,"Effingham County, Illinois",32901,24843.0,18301,11977,6941,25960
583,17051,"Fayette County, Illinois",23920,21663.0,15357,10496,6044,17876
584,17053,"Ford County, Illinois",29288,23401.0,18860,11895,7530,21758
585,17055,"Franklin County, Illinois",24642,18504.0,15407,10204,6384,18258
586,17057,"Fulton County, Illinois",29850,20309.0,17373,10720,6852,22998
587,17059,"Gallatin County, Illinois",31693,21537.0,15575,10367,5594,26099
588,17061,"Greene County, Illinois",27105,22107.0,15246,9884,5721,21384
589,17063,"Grundy County, Illinois",35483,27895.0,22591,14474,8115,27368
590,17065,"Hamilton County, Illinois",28046,21602.0,16262,9984,5688,22358
591,17067,"Hancock County, Illinois",30405,22885.0,17478,11358,6510,23895
592,17069,"Hardin County, Illinois",27720,18515.0,15984,8314,4976,22744
593,17071,"Henderson County, Illinois",31645,22492.0,17456,10638,6638,25007
594,17073,"Henry County, Illinois",31763,24915.0,18716,12260,7486,24277
595,17075,"Iroquois County, Illinois",28790,23400.0,18435,11653,7034,21756
596,17077,"Jackson County, Illinois",26656,19294.0,15755,10003,6045,20611
597,17079,"Jasper County, Illinois",27877,21467.0,16649,10298,6370,21507
598,17081,"Jefferson County, Illinois",26742,21370.0,16644,11279,6942,19800
599,17083,"Jersey County, Illinois",32544,24368.0,19581,11132,6563,25981
600,17085,"Jo Daviess County, Illinois",34974,26819.0,21497,12497,6915,28059
601,17087,"Johnson County, Illinois",23548,16402.0,17990,9170,5245,18303
602,17089,"Kane County, Illinois",37548,29480.0,24315,15890,8467,29081
603,17091,"Kankakee County, Illinois",28445,22888.0,19055,12142,6812,21633
604,17093,"Kendall County, Illinois",36504,30565.0,25188,16115,8490,28014
605,17095,"Knox County, Illinois",24804,20908.0,17985,11973,7340,17464
606,17097,"Lake County, Illinois",47223,38120.0,32102,21765,10103,37120
607,17099,"La Salle County, Illinois",31020,24982.0,19185,12337,7615,23405
608,17101,"Lawrence County, Illinois",26233,19297.0,17070,10120,6423,19810
609,17103,"Lee County, Illinois",29343,24440.0,18650,12050,7258,22085
610,17105,"Livingston County, Illinois",29646,23259.0,18347,12124,7558,22088
611,17107,"Logan County, Illinois",29377,22063.0,17953,11576,7163,22214
612,17109,"Mcdonough County, Illinois",25219,18344.0,15890,10089,6300,18919
613,17111,"Mchenry County, Illinois",40545,31838.0,26476,17271,8641,31904
614,17113,"Mclean County, Illinois",34496,28167.0,22227,14138,7794,26702
615,17115,"Macon County, Illinois",30681,24726.0,20067,13762,7893,22788
616,17117,"Macoupin County, Illinois",28726,23222.0,17298,11365,6501,22225
617,17119,"Madison County, Illinois",33599,26127.0,20509,13272,7304,26295
618,17121,"Marion County, Illinois",26853,20493.0,17235,11500,6605,20248
619,17123,"Marshall County, Illinois",29533,24991.0,19065,12109,7338,22195
620,17125,"Mason County, Illinois",30144,23427.0,17357,11036,7038,23106
621,17127,"Massac County, Illinois",24624,20216.0,16334,10136,6216,18408
622,17129,"Menard County, Illinois",39221,26281.0,21584,12954,7434,31787
623,17131,"Mercer County, Illinois",30493,25332.0,18645,12058,7024,23469
624,17133,"Monroe County, Illinois",43435,31091.0,22954,13886,7650,35785
625,17135,"Montgomery County, Illinois",27510,21700.0,16272,10724,6683,20827
626,17137,"Morgan County, Illinois",29047,23244.0,18205,12372,7279,21768
627,17139,"Moultrie County, Illinois",30734,22954.0,18562,11840,6938,23796
628,17141,"Ogle County, Illinois",31974,24959.0,20515,12880,7392,24582
629,17143,"Peoria County, Illinois",32371,28157.0,21219,13924,8343,24028
630,17145,"Perry County, Illinois",24442,17926.0,15935,10751,7191,17251
631,17147,"Piatt County, Illinois",34674,26492.0,21075,13690,7888,26786
632,17149,"Pike County, Illinois",26185,19996.0,15946,10200,6142,20043
633,17151,"Pope County, Illinois",22690,20134.0,16440,8977,5070,17620
634,17153,"Pulaski County, Illinois",20898,18444.0,13325,8479,4683,16215
635,17155,"Putnam County, Illinois",32902,27004.0,19792,13672,7773,25129
636,17157,"Randolph County, Illinois",27206,19950.0,17696,11155,6630,20576
637,17159,"Richland County, Illinois",28457,22874.0,16847,11692,6790,21667
638,17161,"Rock Island County, Illinois",30380,25071.0,20164,13214,8241,22139
639,17163,"St. Clair County, Illinois",31511,24770.0,18932,11916,6463,25048
640,17165,"Saline County, Illinois",27421,20903.0,15590,10066,6411,21010
641,17167,"Sangamon County, Illinois",35549,28394.0,23173,14947,8179,27370
642,17169,"Schuyler County, Illinois",26479,20649.0,17158,10080,6366,20113
643,17171,"Scott County, Illinois",29120,27530.0,16998,10505,6431,22689
644,17173,"Shelby County, Illinois",28234,21891.0,17313,11608,6671,21563
645,17175,"Stark County, Illinois",29007,25311.0,16767,11241,7076,21931
646,17177,"Stephenson County, Illinois",28893,22608.0,19794,13156,7433,21460
647,17179,"Tazewell County, Illinois",33854,27036.0,21511,13681,8237,25617
648,17181,"Union County, Illinois",27778,19512.0,16450,10180,6489,21289
649,17183,"Vermilion County, Illinois",25484,20218.0,16787,11771,6950,18534
650,17185,"Wabash County, Illinois",29252,23350.0,16747,12072,7379,21873
651,17187,"Warren County, Illinois",27899,20047.0,16946,10591,6927,20972
652,17189,"Washington County, Illinois",32687,24846.0,19108,11539,6608,26079
653,17191,"Wayne County, Illinois",26502,21493.0,15793,10139,6301,20201
654,17193,"White County, Illinois",27449,22081.0,16412,11332,6912,20537
655,17195,"Whiteside County, Illinois",31185,23405.0,19296,12245,7700,23485
656,17197,"Will County, Illinois",37967,29811.0,24613,15186,7999,29968
657,17199,"Williamson County, Illinois",29092,22164.0,17779,11254,6513,22579
658,17201,"Winnebago County, Illinois",29894,24008.0,21194,14516,7935,21959
659,17203,"Woodford County, Illinois",37751,29475.0,21956,13516,7775,29976
660,18001,"Adams County, Indiana",22617,19089.0,16704,11655,6459,16158
661,18003,"Allen County, Indiana",29951,24532.0,21544,14631,7766,22185
662,18005,"Bartholomew County, Indiana",32371,26860.0,21536,14216,7947,24424
663,18007,"Benton County, Indiana",27353,21949.0,17220,12024,6906,20447
664,18009,"Blackford County, Indiana",25287,21783.0,16543,11151,6157,19130
665,18011,"Boone County, Indiana",48835,38696.0,24182,16674,8030,40805
666,18013,"Brown County, Indiana",35000,24312.0,20548,13048,6690,28310
667,18015,"Carroll County, Indiana",29527,23163.0,19436,12165,6976,22551
668,18017,"Cass County, Indiana",25184,20562.0,18892,11860,7031,18153
669,18019,"Clark County, Indiana",29279,23592.0,19936,12068,6562,22717
670,18021,"Clay County, Indiana",27298,20569.0,16364,10538,6218,21080
671,18023,"Clinton County, Indiana",24678,21131.0,17862,11849,6960,17718
672,18025,"Crawford County, Indiana",23001,18598.0,15926,8837,5115,17886
673,18027,"Daviess County, Indiana",23600,20254.0,16015,10176,5565,18035
674,18029,"Dearborn County, Indiana",31992,25023.0,20431,12542,6568,25424
675,18031,"Decatur County, Indiana",28190,22719.0,18582,11930,6013,22177
676,18033,"De Kalb County, Indiana",28782,21779.0,19448,12665,6760,22022
677,18035,"Delaware County, Indiana",25718,20405.0,19233,12168,6716,19002
678,18037,"Dubois County, Indiana",31605,24801.0,20225,12942,6926,24679
679,18039,"Elkhart County, Indiana",26806,22187.0,20250,13825,7222,19584
680,18041,"Fayette County, Indiana",23839,18928.0,18624,11577,6072,17767
681,18043,"Floyd County, Indiana",34609,25971.0,21852,13203,6844,27765
682,18045,"Fountain County, Indiana",26636,20949.0,17779,11470,6505,20131
683,18047,"Franklin County, Indiana",32095,23090.0,18624,11295,5757,26338
684,18049,"Fulton County, Indiana",26865,21119.0,17950,11164,6717,20148
685,18051,"Gibson County, Indiana",28105,22542.0,18169,11615,6940,21165
686,18053,"Grant County, Indiana",24255,19792.0,18003,12308,6703,17552
687,18055,"Greene County, Indiana",26236,20676.0,16834,10798,6063,20173
688,18057,"Hamilton County, Indiana",49196,38500.0,33109,20426,9426,39770
689,18059,"Hancock County, Indiana",36450,28017.0,24966,15059,7615,28835
690,18061,"Harrison County, Indiana",28056,23539.0,19643,11159,6028,22028
691,18063,"Hendricks County, Indiana",37815,28880.0,23129,15526,7925,29890
692,18065,"Henry County, Indiana",25417,19879.0,19355,11914,6401,19016
693,18067,"Howard County, Indiana",29647,23759.0,22049,14346,7656,21991
694,18069,"Huntington County, Indiana",27441,21575.0,19480,12509,6764,20677
695,18071,"Jackson County, Indiana",26997,21498.0,18400,11562,6243,20754
696,18073,"Jasper County, Indiana",28434,23676.0,19012,11256,6855,21579
697,18075,"Jay County, Indiana",24165,18946.0,16686,10331,5925,18240
698,18077,"Jefferson County, Indiana",27845,21278.0,17412,11631,6050,21795
699,18079,"Jennings County, Indiana",26879,18636.0,17059,10333,5802,21077
700,18081,"Johnson County, Indiana",35048,28224.0,22976,14992,7520,27528
701,18083,"Knox County, Indiana",27521,20381.0,16085,11077,6166,21355
702,18085,"Kosciusko County, Indiana",30951,24019.0,19806,13323,6864,24087
703,18087,"Lagrange County, Indiana",25588,18388.0,16481,10011,5638,19950
704,18089,"Lake County, Indiana",29951,23142.0,19639,12663,7725,22226
705,18091,"La Porte County, Indiana",27706,22599.0,18913,12973,7279,20427
706,18093,"Lawrence County, Indiana",28561,21352.0,17653,11492,6302,22259
707,18095,"Madison County, Indiana",26379,21722.0,20090,12811,7161,19218
708,18097,"Marion County, Indiana",30013,24498.0,21789,14614,7677,22336
709,18099,"Marshall County, Indiana",26590,22493.0,18427,12428,6705,19885
710,18101,"Martin County, Indiana",26576,21750.0,17054,10177,5377,21199
711,18103,"Miami County, Indiana",24439,18854.0,17726,10862,6222,18217
712,18105,"Monroe County, Indiana",29675,21882.0,18534,12017,6303,23372
713,18107,"Montgomery County, Indiana",29257,22788.0,18938,12419,6968,22289
714,18109,"Morgan County, Indiana",31856,23972.0,20657,13068,7018,24838
715,18111,"Newton County, Indiana",27742,24055.0,17755,11925,6690,21052
716,18113,"Noble County, Indiana",27532,19783.0,17896,11772,6235,21297
717,18115,"Ohio County, Indiana",31873,25703.0,19627,10786,6259,25614
718,18117,"Orange County, Indiana",26600,19119.0,16717,9222,5318,21282
719,18119,"Owen County, Indiana",25602,20581.0,16884,10572,5769,19833
720,18121,"Parke County, Indiana",25056,19494.0,16986,11058,6172,18884
721,18123,"Perry County, Indiana",25436,20806.0,16673,10567,6047,19389
722,18125,"Pike County, Indiana",27889,20005.0,16217,10934,6535,21354
723,18127,"Porter County, Indiana",35672,27922.0,23957,15059,8459,27213
724,18129,"Posey County, Indiana",32136,26727.0,19516,12879,6924,25212
725,18131,"Pulaski County, Indiana",26171,20491.0,16835,11107,6336,19835
726,18133,"Putnam County, Indiana",25686,20441.0,17163,11154,6482,19204
727,18135,"Randolph County, Indiana",26960,19552.0,16954,11241,6149,20811
728,18137,"Ripley County, Indiana",30800,22025.0,17559,11563,5739,25061
729,18139,"Rush County, Indiana",27133,21215.0,17997,10869,6019,21114
730,18141,"St. Joseph County, Indiana",29635,23082.0,19756,13277,7322,22313
731,18143,"Scott County, Indiana",23820,19414.0,16065,9766,5410,18410
732,18145,"Shelby County, Indiana",29452,26398.0,20324,12935,6926,22526
733,18147,"Spencer County, Indiana",32105,23609.0,18000,11462,6251,25854
734,18149,"Starke County, Indiana",24105,17991.0,16466,9980,5641,18464
735,18151,"Steuben County, Indiana",31000,22950.0,20647,12399,6833,24167
736,18153,"Sullivan County, Indiana",25021,20093.0,16234,10668,6303,18718
737,18155,"Switzerland County, Indiana",26288,21214.0,17466,10201,5196,21092
738,18157,"Tippecanoe County, Indiana",27622,22203.0,19375,12570,6929,20693
739,18159,"Tipton County, Indiana",32880,23499.0,21926,13669,7520,25360
740,18161,"Union County, Indiana",28820,19243.0,19549,10700,5903,22917
741,18163,"Vanderburgh County, Indiana",29731,23945.0,20655,13434,7480,22251
742,18165,"Vermillion County, Indiana",26955,22178.0,18579,11217,6151,20804
743,18167,"Vigo County, Indiana",26380,20398.0,17620,11973,6671,19709
744,18169,"Wabash County, Indiana",27170,20475.0,18192,11511,6722,20448
745,18171,"Warren County, Indiana",34291,23670.0,18070,10911,6600,27691
746,18173,"Warrick County, Indiana",40276,29737.0,21893,14037,7520,32756
747,18175,"Washington County, Indiana",25047,19278.0,16748,10187,5457,19590
748,18177,"Wayne County, Indiana",26605,21789.0,17727,11535,6512,20093
749,18179,"Wells County, Indiana",28828,23169.0,19158,12765,7194,21634
750,18181,"White County, Indiana",27948,22323.0,18323,12111,6816,21132
751,18183,"Whitley County, Indiana",32020,24644.0,20519,12605,6793,25227
752,19001,"Adair County, Iowa",30662,23497.0,17262,10565,5946,24716
753,19003,"Adams County, Iowa",29079,23549.0,15550,10110,5797,23282
754,19005,"Allamakee County, Iowa",28546,21349.0,16599,10232,5314,23232
755,19007,"Appanoose County, Iowa",25455,20084.0,14644,9748,5483,19972
756,19009,"Audubon County, Iowa",29132,24207.0,17489,11210,6167,22965
757,19011,"Benton County, Iowa",32221,25111.0,18891,11373,6870,25351
758,19013,"Black Hawk County, Iowa",31347,23357.0,18885,12321,7735,23612
759,19015,"Boone County, Iowa",34016,25998.0,19943,12031,7089,26927
760,19017,"Bremer County, Iowa",33510,26522.0,19199,11626,6984,26526
761,19019,"Buchanan County, Iowa",33287,23437.0,18405,10925,6268,27019
762,19021,"Buena Vista County, Iowa",26230,21256.0,16042,11423,7373,18857
763,19023,"Butler County, Iowa",30186,24030.0,17036,10803,6356,23830
764,19025,"Calhoun County, Iowa",29557,23049.0,17498,11405,6946,22611
765,19027,"Carroll County, Iowa",32274,25094.0,18595,11301,6674,25600
766,19029,"Cass County, Iowa",30479,21787.0,17067,11059,6654,23825
767,19031,"Cedar County, Iowa",32122,24742.0,19200,12113,7016,25106
768,19033,"Cerro Gordo County, Iowa",33567,25463.0,19184,12304,7371,26196
769,19035,"Cherokee County, Iowa",33882,24507.0,17934,10909,7196,26686
770,19037,"Chickasaw County, Iowa",31027,22447.0,18237,10919,6087,24940
771,19039,"Clarke County, Iowa",28723,23271.0,16409,11380,5733,22990
772,19041,"Clay County, Iowa",29707,25398.0,19451,12314,7470,22237
773,19043,"Clayton County, Iowa",29586,22303.0,16930,9813,5875,23711
774,19045,"Clinton County, Iowa",28761,23573.0,17724,11795,7175,21586
775,19047,"Crawford County, Iowa",30228,21181.0,15851,10056,6435,23793
776,19049,"Dallas County, Iowa",45319,33051.0,22970,13364,7503,37816
777,19051,"Davis County, Iowa",28818,21970.0,15127,9965,5843,22975
778,19053,"Decatur County, Iowa",23469,18195.0,14209,8918,5007,18462
779,19055,"Delaware County, Iowa",34681,22578.0,17327,11515,5961,28720
780,19057,"Des Moines County, Iowa",31046,22555.0,19701,12246,7498,23548
781,19059,"Dickinson County, Iowa",39366,29459.0,21929,13639,7341,32025
782,19061,"Dubuque County, Iowa",34275,25045.0,19600,12331,7063,27212
783,19063,"Emmet County, Iowa",30110,24371.0,16619,10402,6823,23287
784,19065,"Fayette County, Iowa",28269,21566.0,17271,10226,6297,21972
785,19067,"Floyd County, Iowa",30547,21416.0,17091,11307,6636,23911
786,19069,"Franklin County, Iowa",28650,22507.0,18767,11691,6770,21880
787,19071,"Fremont County, Iowa",31173,23612.0,18081,10674,6169,25004
788,19073,"Greene County, Iowa",29356,23947.0,16866,11164,6823,22533
789,19075,"Grundy County, Iowa",37360,26916.0,19142,12898,7592,29768
790,19077,"Guthrie County, Iowa",33818,26590.0,19726,11201,6190,27628
791,19079,"Hamilton County, Iowa",31397,24765.0,18801,11879,7108,24289
792,19081,"Hancock County, Iowa",31178,22713.0,17957,11064,6778,24400
793,19083,"Hardin County, Iowa",28189,24154.0,17537,11356,6867,21322
794,19085,"Harrison County, Iowa",33333,24221.0,17662,10411,5989,27344
795,19087,"Henry County, Iowa",26840,23056.0,18192,11355,6689,20151
796,19089,"Howard County, Iowa",28351,22417.0,17842,9960,6398,21953
797,19091,"Humboldt County, Iowa",30396,24568.0,18300,12167,7187,23209
798,19093,"Ida County, Iowa",31481,23841.0,18675,10993,6764,24717
799,19095,"Iowa County, Iowa",33910,26721.0,18884,12139,6965,26945
800,19097,"Jackson County, Iowa",30694,23008.0,17329,10467,6313,24381
801,19099,"Jasper County, Iowa",29576,23160.0,19622,12872,7100,22476
802,19101,"Jefferson County, Iowa",28849,23853.0,19579,11664,6185,22664
803,19103,"Johnson County, Iowa",35875,28008.0,22220,14113,7627,28248
804,19105,"Jones County, Iowa",29560,22873.0,17816,10403,6247,23313
805,19107,"Keokuk County, Iowa",30097,22088.0,17120,10427,6214,23883
806,19109,"Kossuth County, Iowa",31475,27415.0,16598,11247,6544,24931
807,19111,"Lee County, Iowa",27834,21324.0,18430,11488,7052,20782
808,19113,"Linn County, Iowa",36321,28239.0,22977,14902,8094,28227
809,19115,"Louisa County, Iowa",29762,20367.0,17644,11226,6606,23156
810,19117,"Lucas County, Iowa",30003,19967.0,15341,11048,5949,24054
811,19119,"Lyon County, Iowa",29410,21613.0,16081,9871,6251,23159
812,19121,"Madison County, Iowa",37951,25711.0,19357,11620,6354,31597
813,19123,"Mahaska County, Iowa",28511,21568.0,18232,10819,6319,22192
814,19125,"Marion County, Iowa",33571,24613.0,18717,11945,6553,27018
815,19127,"Marshall County, Iowa",28152,22407.0,19176,13231,7542,20610
816,19129,"Mills County, Iowa",35711,25400.0,18736,11140,6469,29242
817,19131,"Mitchell County, Iowa",31327,22820.0,16809,11035,6881,24446
818,19133,"Monona County, Iowa",30221,22774.0,17477,10584,6165,24056
819,19135,"Monroe County, Iowa",30732,21228.0,17155,10046,6031,24701
820,19137,"Montgomery County, Iowa",34545,21301.0,16373,11595,6797,27748
821,19139,"Muscatine County, Iowa",30902,24138.0,19625,12802,7338,23564
822,19141,"O'brien County, Iowa",31149,24771.0,17281,10842,6738,24411
823,19143,"Osceola County, Iowa",31097,23063.0,16463,11508,6672,24425
824,19145,"Page County, Iowa",27800,21204.0,16670,11122,6387,21413
825,19147,"Palo Alto County, Iowa",29636,23071.0,17733,10749,6425,23211
826,19149,"Plymouth County, Iowa",35078,28060.0,19442,11507,6714,28364
827,19151,"Pocahontas County, Iowa",30428,23385.0,17006,11531,6928,23500
828,19153,"Polk County, Iowa",36290,29246.0,23654,15365,8305,27985
829,19155,"Pottawattamie County, Iowa",30466,23782.0,19275,11734,6801,23665
830,19157,"Poweshiek County, Iowa",34576,25218.0,18629,12066,6519,28057
831,19159,"Ringgold County, Iowa",27414,21858.0,15023,9773,5318,22096
832,19161,"Sac County, Iowa",32704,23837.0,16902,10852,6730,25974
833,19163,"Scott County, Iowa",34792,27408.0,21310,13625,8226,26566
834,19165,"Shelby County, Iowa",34617,22389.0,16969,10720,6327,28290
835,19167,"Sioux County, Iowa",30044,21333.0,16532,10411,6136,23908
836,19169,"Story County, Iowa",31037,25450.0,19949,11958,6991,24046
837,19171,"Tama County, Iowa",28623,23041.0,17097,11362,6395,22228
838,19173,"Taylor County, Iowa",31551,21335.0,15082,8834,5570,25981
839,19175,"Union County, Iowa",27212,20435.0,16690,10247,6224,20988
840,19177,"Van Buren County, Iowa",28466,20209.0,15748,9348,5156,23310
841,19179,"Wapello County, Iowa",25760,22376.0,16500,11055,6866,18894
842,19181,"Warren County, Iowa",35966,28798.0,20558,12732,7035,28931
843,19183,"Washington County, Iowa",30390,23979.0,18221,11387,6631,23759
844,19185,"Wayne County, Iowa",26026,18795.0,15613,9225,5460,20566
845,19187,"Webster County, Iowa",28116,22653.0,17857,11358,7164,20952
846,19189,"Winnebago County, Iowa",28927,22684.0,18494,10775,6613,22314
847,19191,"Winneshiek County, Iowa",32383,23608.0,17047,10503,5682,26701
848,19193,"Woodbury County, Iowa",28919,22069.0,18771,12218,6917,22002
849,19195,"Worth County, Iowa",32381,27240.0,16952,11443,7134,25247
850,19197,"Wright County, Iowa",29142,23068.0,18247,11969,7214,21928
851,20001,"Allen County, Kansas",23493,20195.0,15640,9889,6222,17271
852,20003,"Anderson County, Kansas",26290,20558.0,16458,10190,5829,20461
853,20005,"Atchison County, Kansas",24250,20995.0,15207,10144,5910,18340
854,20007,"Barber County, Kansas",28934,23542.0,16627,10664,7612,21322
855,20009,"Barton County, Kansas",27333,23688.0,16695,11394,7217,20116
856,20011,"Bourbon County, Kansas",24198,18596.0,16393,9958,6278,17920
857,20013,"Brown County, Kansas",25183,19555.0,15163,10299,5958,19225
858,20015,"Butler County, Kansas",30689,26436.0,20150,13260,7456,23233
859,20017,"Chase County, Kansas",29645,21890.0,17422,10258,6332,23313
860,20019,"Chautauqua County, Kansas",23909,21613.0,16280,9043,6075,17834
861,20021,"Cherokee County, Kansas",23238,20075.0,14710,9705,5643,17595
862,20023,"Cheyenne County, Kansas",29914,19460.0,17862,11165,6700,23214
863,20025,"Clark County, Kansas",29227,24605.0,17795,11804,7207,22020
864,20027,"Clay County, Kansas",28784,24858.0,17939,11431,6113,22671
865,20029,"Cloud County, Kansas",25589,18690.0,17536,10853,5720,19869
866,20031,"Coffey County, Kansas",33494,23744.0,18337,11451,6510,26984
867,20033,"Comanche County, Kansas",29271,22974.0,17037,10587,6882,22389
868,20035,"Cowley County, Kansas",26743,20720.0,17509,11624,6969,19774
869,20037,"Crawford County, Kansas",23936,19753.0,16245,10507,5913,18023
870,20039,"Decatur County, Kansas",29659,21966.0,16348,10609,6681,22978
871,20041,"Dickinson County, Kansas",31153,22009.0,17780,11407,6341,24812
872,20043,"Doniphan County, Kansas",26916,21704.0,14849,9465,5572,21344
873,20045,"Douglas County, Kansas",32776,24851.0,19952,12003,6473,26303
874,20047,"Edwards County, Kansas",27487,24899.0,17586,11895,6372,21115
875,20049,"Elk County, Kansas",25374,20958.0,16066,10390,5455,19919
876,20051,"Ellis County, Kansas",30625,24093.0,18259,11459,6603,24022
877,20053,"Ellsworth County, Kansas",27402,21704.0,16569,9801,5863,21539
878,20055,"Finney County, Kansas",25204,20976.0,15377,11278,7133,18071
879,20057,"Ford County, Kansas",24364,19348.0,15721,11114,7006,17358
880,20059,"Franklin County, Kansas",27534,22294.0,17311,11483,6643,20891
881,20061,"Geary County, Kansas",24177,20709.0,16199,9996,5947,18230
882,20063,"Gove County, Kansas",32012,22775.0,17852,10859,5867,26145
883,20065,"Graham County, Kansas",26616,25026.0,18050,11472,6479,20137
884,20067,"Grant County, Kansas",31400,25188.0,17072,10757,7148,24252
885,20069,"Gray County, Kansas",31151,22606.0,18632,11669,6739,24412
886,20071,"Greeley County, Kansas",27300,28698.0,19974,11641,6785,20515
887,20073,"Greenwood County, Kansas",28912,21325.0,15976,10694,6176,22736
888,20075,"Hamilton County, Kansas",22558,20190.0,16484,12366,6229,16329
889,20077,"Harper County, Kansas",25119,22467.0,16368,10717,6752,18367
890,20079,"Harvey County, Kansas",29169,22890.0,18715,12725,7008,22161
891,20081,"Haskell County, Kansas",31535,21966.0,17349,10990,6433,25102
892,20083,"Hodgeman County, Kansas",30218,20859.0,15599,10347,6850,23368
893,20085,"Jackson County, Kansas",28853,23306.0,18606,10891,6169,22684
894,20087,"Jefferson County, Kansas",33441,25580.0,19373,12267,6635,26806
895,20089,"Jewell County, Kansas",27982,22443.0,16644,9698,5597,22385
896,20091,"Johnson County, Kansas",47997,37882.0,30919,20592,10680,37317
897,20093,"Kearny County, Kansas",22971,20888.0,15708,11412,6815,16156
898,20095,"Kingman County, Kansas",35664,22861.0,18533,10676,6688,28976
899,20097,"Kiowa County, Kansas",25889,19430.0,17207,10607,6868,19021
900,20099,"Labette County, Kansas",24963,21021.0,15525,10815,5975,18988
901,20101,"Lane County, Kansas",28775,25261.0,18606,12159,6825,21950
902,20103,"Leavenworth County, Kansas",32893,25925.0,20292,12822,6649,26244
903,20105,"Lincoln County, Kansas",26545,23084.0,15788,9668,5947,20598
904,20107,"Linn County, Kansas",30070,22472.0,17009,11001,5929,24141
905,20109,"Logan County, Kansas",28078,22856.0,17294,10878,6292,21786
906,20111,"Lyon County, Kansas",26429,18245.0,15724,11251,6959,19470
907,20113,"Mcpherson County, Kansas",31579,26467.0,18921,11970,6973,24606
908,20115,"Marion County, Kansas",26282,21166.0,16100,10428,6182,20100
909,20117,"Marshall County, Kansas",29502,21295.0,17090,10166,6437,23065
910,20119,"Meade County, Kansas",30774,23909.0,16824,10887,6101,24673
911,20121,"Miami County, Kansas",35642,26218.0,21408,12563,6975,28667
912,20123,"Mitchell County, Kansas",26117,23350.0,17653,10465,6139,19978
913,20125,"Montgomery County, Kansas",25719,21037.0,16421,10837,6587,19132
914,20127,"Morris County, Kansas",29407,23967.0,18491,11451,6196,23211
915,20129,"Morton County, Kansas",23754,22862.0,17076,12669,6895,16859
916,20131,"Nemaha County, Kansas",31715,22484.0,17121,10738,5684,26031
917,20133,"Neosho County, Kansas",24975,18683.0,16539,10402,6496,18479
918,20135,"Ness County, Kansas",31999,27622.0,17787,11034,6836,25163
919,20137,"Norton County, Kansas",27752,19080.0,16835,10912,6232,21520
920,20139,"Osage County, Kansas",28945,22697.0,17691,10823,6398,22547
921,20141,"Osborne County, Kansas",30453,22536.0,16236,9913,5729,24724
922,20143,"Ottawa County, Kansas",33655,22665.0,17663,10358,5920,27735
923,20145,"Pawnee County, Kansas",25746,17927.0,17584,12531,6771,18975
924,20147,"Phillips County, Kansas",29527,21870.0,17121,10270,6119,23408
925,20149,"Pottawatomie County, Kansas",30763,25157.0,17785,10984,6145,24618
926,20151,"Pratt County, Kansas",29607,23585.0,17906,12488,7182,22425
927,20153,"Rawlins County, Kansas",30651,22895.0,17161,10468,6093,24558
928,20155,"Reno County, Kansas",27613,22149.0,18520,12074,7114,20499
929,20157,"Republic County, Kansas",28100,24731.0,17433,10890,5906,22194
930,20159,"Rice County, Kansas",26324,19316.0,16064,10139,6907,19417
931,20161,"Riley County, Kansas",27975,19999.0,16349,10067,5736,22239
932,20163,"Rooks County, Kansas",27023,23435.0,15588,10223,6286,20737
933,20165,"Rush County, Kansas",27291,23608.0,18033,10516,6131,21160
934,20167,"Russell County, Kansas",26921,23243.0,17073,11338,7474,19447
935,20169,"Saline County, Kansas",29509,23669.0,19073,13153,7416,22093
936,20171,"Scott County, Kansas",28965,28872.0,20443,11332,6942,22023
937,20173,"Sedgwick County, Kansas",30340,25297.0,20907,14555,8160,22180
938,20175,"Seward County, Kansas",21434,18083.0,15059,11341,7804,13630
939,20177,"Shawnee County, Kansas",31574,25705.0,20904,14091,7858,23716
940,20179,"Sheridan County, Kansas",39170,24933.0,16299,9889,5576,33594
941,20181,"Sherman County, Kansas",36495,22651.0,16761,10356,6554,29941
942,20183,"Smith County, Kansas",29017,23644.0,14983,9574,5347,23670
943,20185,"Stafford County, Kansas",27897,23171.0,16409,10496,6477,21420
944,20187,"Stanton County, Kansas",29716,19196.0,18043,11025,6122,23594
945,20189,"Stevens County, Kansas",23355,21633.0,17814,11584,7182,16173
946,20191,"Sumner County, Kansas",27499,23114.0,18305,11944,7213,20286
947,20193,"Thomas County, Kansas",34865,23883.0,19028,10551,6762,28103
948,20195,"Trego County, Kansas",36415,22095.0,16239,10464,6472,29943
949,20197,"Wabaunsee County, Kansas",30047,23072.0,17704,11280,6381,23666
950,20199,"Wallace County, Kansas",25262,23269.0,17016,9366,5353,19909
951,20201,"Washington County, Kansas",28646,20577.0,15515,9595,5690,22956
952,20203,"Wichita County, Kansas",30803,20375.0,16720,10196,5975,24828
953,20205,"Wilson County, Kansas",27661,18708.0,14910,9734,5686,21975
954,20207,"Woodson County, Kansas",26969,23986.0,14283,10424,5561,21408
955,20209,"Wyandotte County, Kansas",23111,18827.0,16005,10656,6444,16667
956,21001,"Adair County, Kentucky",22751,15790.0,14931,8596,4482,18269
957,21003,"Allen County, Kentucky",23299,16897.0,14506,8361,5045,18254
958,21005,"Anderson County, Kentucky",28143,24516.0,18621,12320,6117,22026
959,21007,"Ballard County, Kentucky",26911,23001.0,19035,10262,5798,21113
960,21009,"Barren County, Kentucky",22502,20067.0,16816,9876,5500,17002
961,21011,"Bath County, Kentucky",24167,15487.0,15326,8034,4309,19858
962,21013,"Bell County, Kentucky",16416,14627.0,11526,7037,4573,11843
963,21015,"Boone County, Kentucky",36371,28520.0,23535,13576,7200,29171
964,21017,"Bourbon County, Kentucky",27676,21355.0,18335,10858,5694,21982
965,21019,"Boyd County, Kentucky",26055,22064.0,18212,12012,6973,19082
966,21021,"Boyle County, Kentucky",26575,22534.0,18288,11029,6225,20350
967,21023,"Bracken County, Kentucky",25587,18671.0,16478,9297,5014,20573
968,21025,"Breathitt County, Kentucky",20325,16442.0,11044,6905,4277,16048
969,21027,"Breckinridge County, Kentucky",24458,17757.0,15402,9157,4859,19599
970,21029,"Bullitt County, Kentucky",30075,22791.0,18339,10907,5677,24398
971,21031,"Butler County, Kentucky",22672,17236.0,14617,8108,4545,18127
972,21033,"Caldwell County, Kentucky",32439,19498.0,16264,9658,5845,26594
973,21035,"Calloway County, Kentucky",23984,20951.0,16566,10434,5885,18099
974,21037,"Campbell County, Kentucky",35124,27096.0,20637,12603,6564,28560
975,21039,"Carlisle County, Kentucky",29638,17260.0,16276,9735,5590,24048
976,21041,"Carroll County, Kentucky",25084,21845.0,17057,10202,5667,19417
977,21043,"Carter County, Kentucky",20672,18147.0,13442,7996,4453,16219
978,21045,"Casey County, Kentucky",18384,14252.0,12867,7719,3775,14609
979,21047,"Christian County, Kentucky",24489,18476.0,14611,9708,5240,19249
980,21049,"Clark County, Kentucky",30194,23966.0,19170,11655,6485,23709
981,21051,"Clay County, Kentucky",15905,12300.0,9716,6084,3481,12424
982,21053,"Clinton County, Kentucky",21730,14802.0,13286,6838,3330,18400
983,21055,"Crittenden County, Kentucky",24732,19463.0,15262,9807,5468,19264
984,21057,"Cumberland County, Kentucky",20685,15025.0,12643,6858,4177,16508
985,21059,"Daviess County, Kentucky",30186,22064.0,18739,11456,6543,23643
986,21061,"Edmonson County, Kentucky",22818,18959.0,14480,7181,4150,18668
987,21063,"Elliott County, Kentucky",13857,13072.0,12067,6823,3906,9951
988,21065,"Estill County, Kentucky",18609,15725.0,12285,7474,4440,14169
989,21067,"Fayette County, Kentucky",35466,28345.0,23109,14962,7395,28071
990,21069,"Fleming County, Kentucky",23512,17629.0,14214,8950,4721,18791
991,21071,"Floyd County, Kentucky",19932,15883.0,12442,7922,4982,14950
992,21073,"Franklin County, Kentucky",31994,26857.0,21229,13383,7309,24685
993,21075,"Fulton County, Kentucky",19149,16908.0,14309,9820,5435,13714
994,21077,"Gallatin County, Kentucky",23057,17810.0,16416,9717,5531,17526
995,21079,"Garrard County, Kentucky",27179,18735.0,16915,10011,4965,22214
996,21081,"Grant County, Kentucky",25292,20257.0,16776,10356,5648,19644
997,21083,"Graves County, Kentucky",25557,19976.0,16834,10784,6048,19509
998,21085,"Grayson County, Kentucky",21339,17443.0,14759,8767,4653,16686
999,21087,"Green County, Kentucky",23407,21281.0,16107,9177,4636,18771
1000,21089,"Greenup County, Kentucky",27496,21533.0,17137,11165,6425,21071
1001,21091,"Hancock County, Kentucky",25891,19952.0,16623,10891,5629,20262
1002,21093,"Hardin County, Kentucky",30779,22997.0,17487,10624,5448,25331
1003,21095,"Harlan County, Kentucky",17385,15224.0,11585,7502,4952,12433
1004,21097,"Harrison County, Kentucky",25226,20037.0,17478,10271,5369,19857
1005,21099,"Hart County, Kentucky",21542,16726.0,13495,8142,4895,16647
1006,21101,"Henderson County, Kentucky",27490,22192.0,18470,12042,6972,20518
1007,21103,"Henry County, Kentucky",24823,21090.0,17846,10344,5369,19454
1008,21105,"Hickman County, Kentucky",30609,19953.0,17279,9777,5985,24624
1009,21107,"Hopkins County, Kentucky",24883,21347.0,17382,10751,6562,18321
1010,21109,"Jackson County, Kentucky",17573,13935.0,10711,7097,3560,14013
1011,21111,"Jefferson County, Kentucky",34365,26473.0,22352,14067,7324,27041
1012,21113,"Jessamine County, Kentucky",33110,24097.0,18842,11733,5806,27304
1013,21115,"Johnson County, Kentucky",22196,18486.0,14051,8492,5215,16981
1014,21117,"Kenton County, Kentucky",34936,27205.0,22085,13587,6867,28069
1015,21119,"Knott County, Kentucky",18723,16110.0,11297,6753,4335,14388
1016,21121,"Knox County, Kentucky",17665,14101.0,10660,7776,3988,13677
1017,21123,"Larue County, Kentucky",24231,18474.0,15865,10129,5093,19138
1018,21125,"Laurel County, Kentucky",23283,19604.0,14165,8879,4807,18476
1019,21127,"Lawrence County, Kentucky",17882,15903.0,12008,7809,4584,13298
1020,21129,"Lee County, Kentucky",17946,12983.0,13325,6869,4004,13942
1021,21131,"Leslie County, Kentucky",18011,14753.0,10429,7190,4055,13956
1022,21133,"Letcher County, Kentucky",22103,17393.0,11984,7340,4546,17557
1023,21135,"Lewis County, Kentucky",18853,14915.0,12031,7477,4014,14839
1024,21137,"Lincoln County, Kentucky",21716,16985.0,13602,8388,4431,17285
1025,21139,"Livingston County, Kentucky",28504,20800.0,17072,10123,5743,22761
1026,21141,"Logan County, Kentucky",25026,19443.0,15962,9907,5316,19710
1027,21143,"Lyon County, Kentucky",26993,19036.0,16016,10081,5826,21167
1028,21145,"Mccracken County, Kentucky",30044,24709.0,19533,12460,6931,23113
1029,21147,"Mccreary County, Kentucky",16016,12197.0,9896,5153,3246,12770
1030,21149,"Mclean County, Kentucky",27855,21071.0,16046,9599,5646,22209
1031,21151,"Madison County, Kentucky",26528,21536.0,16790,10029,5114,21414
1032,21153,"Magoffin County, Kentucky",17939,13849.0,10685,6289,4016,13923
1033,21155,"Marion County, Kentucky",22747,18445.0,14472,9121,4547,18200
1034,21157,"Marshall County, Kentucky",30564,23056.0,18069,11374,6354,24210
1035,21159,"Martin County, Kentucky",19063,14785.0,10650,8190,5261,13802
1036,21161,"Mason County, Kentucky",29371,21717.0,16589,9888,5490,23881
1037,21163,"Meade County, Kentucky",29173,18823.0,16000,9234,4971,24202
1038,21165,"Menifee County, Kentucky",20283,15418.0,11399,6911,3698,16585
1039,21167,"Mercer County, Kentucky",27748,23645.0,17972,10821,5752,21996
1040,21169,"Metcalfe County, Kentucky",20182,16835.0,13236,7542,4752,15430
1041,21171,"Monroe County, Kentucky",24007,15534.0,14365,8347,4243,19764
1042,21173,"Montgomery County, Kentucky",22437,20004.0,16701,9636,5152,17285
1043,21175,"Morgan County, Kentucky",18919,17705.0,12657,6871,4005,14914
1044,21177,"Muhlenberg County, Kentucky",25692,18538.0,14798,9779,6054,19638
1045,21179,"Nelson County, Kentucky",30856,21763.0,18120,10165,5362,25494
1046,21181,"Nicholas County, Kentucky",24356,18452.0,15880,9116,5000,19356
1047,21183,"Ohio County, Kentucky",24728,18258.0,15317,8056,5643,19085
1048,21185,"Oldham County, Kentucky",44186,32702.0,25374,15510,7196,36990
1049,21187,"Owen County, Kentucky",25997,21754.0,15521,9559,4738,21259
1050,21189,"Owsley County, Kentucky",18917,10767.0,10742,5791,2946,15971
1051,21191,"Pendleton County, Kentucky",25647,19523.0,16551,9525,5152,20495
1052,21193,"Perry County, Kentucky",24466,19049.0,12224,7914,4917,19549
1053,21195,"Pike County, Kentucky",22515,18973.0,14005,8674,5437,17078
1054,21197,"Powell County, Kentucky",21484,15796.0,13060,7474,4218,17266
1055,21199,"Pulaski County, Kentucky",26063,19540.0,15352,9209,5064,20999
1056,21201,"Robertson County, Kentucky",23794,15374.0,13404,8630,4392,19402
1057,21203,"Rockcastle County, Kentucky",22597,15621.0,12337,7630,3889,18708
1058,21205,"Rowan County, Kentucky",23985,17435.0,13888,7639,4563,19422
1059,21207,"Russell County, Kentucky",22956,17868.0,13183,8967,4350,18606
1060,21209,"Scott County, Kentucky",33535,26838.0,21490,12314,5951,27584
1061,21211,"Shelby County, Kentucky",33189,27593.0,20195,13064,6331,26858
1062,21213,"Simpson County, Kentucky",24402,20426.0,17150,10635,5799,18603
1063,21215,"Spencer County, Kentucky",35209,25589.0,19848,10502,5303,29906
1064,21217,"Taylor County, Kentucky",25441,18014.0,15162,9848,5456,19985
1065,21219,"Todd County, Kentucky",23971,17460.0,15462,9227,4995,18976
1066,21221,"Trigg County, Kentucky",26953,23387.0,17184,10124,5564,21389
1067,21223,"Trimble County, Kentucky",27194,21161.0,16354,10128,5310,21884
1068,21225,"Union County, Kentucky",23705,18811.0,17465,11080,5914,17791
1069,21227,"Warren County, Kentucky",30138,23206.0,18847,11819,6087,24051
1070,21229,"Washington County, Kentucky",27448,20873.0,15722,9559,5024,22424
1071,21231,"Wayne County, Kentucky",26172,16109.0,12601,6550,3670,22502
1072,21233,"Webster County, Kentucky",24341,18879.0,15657,10263,5996,18345
1073,21235,"Whitley County, Kentucky",21535,15258.0,12777,8028,4673,16862
1074,21237,"Wolfe County, Kentucky",14162,11214.0,10321,5998,3773,10389
1075,21239,"Woodford County, Kentucky",32847,28501.0,22839,14151,6866,25981
1076,22001,"Acadia Parish, Louisiana",25174,18116.0,13424,7952,5657,19517
1077,22003,"Allen Parish, Louisiana",21829,17108.0,13101,7394,5163,16666
1078,22005,"Ascension Parish, Louisiana",35699,26888.0,17858,10482,6346,29353
1079,22007,"Assumption Parish, Louisiana",26952,20348.0,14008,8077,5169,21783
1080,22009,"Avoyelles Parish, Louisiana",21049,16944.0,12146,6874,4479,16570
1081,22011,"Beauregard Parish, Louisiana",27626,21543.0,15514,10096,5921,21705
1082,22013,"Bienville Parish, Louisiana",21513,18873.0,12471,8194,4983,16530
1083,22015,"Bossier Parish, Louisiana",42337,25630.0,18119,11317,6416,35921
1084,22017,"Caddo Parish, Louisiana",27967,22594.0,17839,11604,7206,20761
1085,22019,"Calcasieu Parish, Louisiana",29866,23591.0,17710,11233,7127,22739
1086,22021,"Caldwell Parish, Louisiana",27121,19888.0,13884,8308,5405,21716
1087,22023,"Cameron Parish, Louisiana",28341,24634.0,15348,10289,7166,21175
1088,22025,"Catahoula Parish, Louisiana",21815,17166.0,12608,7862,4825,16990
1089,22027,"Claiborne Parish, Louisiana",15149,16925.0,13825,8076,5184,9965
1090,22029,"Concordia Parish, Louisiana",19963,15911.0,11966,8391,5306,14657
1091,22031,"De Soto Parish, Louisiana",25926,20112.0,13606,8330,5589,20337
1092,22033,"East Baton Rouge Parish, Louisiana",33813,26260.0,19790,13126,7476,26337
1093,22035,"East Carroll Parish, Louisiana",18059,15947.0,9629,6059,4011,14048
1094,22037,"East Feliciana Parish, Louisiana",25718,18376.0,15428,7746,4576,21142
1095,22039,"Evangeline Parish, Louisiana",19578,17561.0,11432,7041,4814,14764
1096,22041,"Franklin Parish, Louisiana",21370,18676.0,12675,7607,4532,16838
1097,22043,"Grant Parish, Louisiana",24228,18536.0,14410,8330,5065,19163
1098,22045,"Iberia Parish, Louisiana",25580,20112.0,14145,9466,6472,19108
1099,22047,"Iberville Parish, Louisiana",24771,19379.0,13272,9449,5479,19292
1100,22049,"Jackson Parish, Louisiana",21937,19308.0,15354,9960,5010,16927
1101,22051,"Jefferson Parish, Louisiana",32939,25842.0,19953,12845,7698,25241
1102,22053,"Jefferson Davis Parish, Louisiana",25821,20487.0,13398,8486,5782,20039
1103,22055,"Lafayette Parish, Louisiana",33254,26791.0,19371,11983,7830,25424
1104,22057,"Lafourche Parish, Louisiana",28220,22898.0,15809,9250,6492,21728
1105,22059,"La Salle Parish, Louisiana",25656,20049.0,14033,9015,5626,20030
1106,22061,"Lincoln Parish, Louisiana",22379,19665.0,14313,9342,5357,17022
1107,22063,"Livingston Parish, Louisiana",30317,23372.0,16282,9946,5951,24366
1108,22065,"Madison Parish, Louisiana",17831,13089.0,10114,6723,4511,13320
1109,22067,"Morehouse Parish, Louisiana",19566,15713.0,13197,8547,4834,14732
1110,22069,"Natchitoches Parish, Louisiana",20219,18207.0,13743,8112,5011,15208
1111,22071,"Orleans Parish, Louisiana",32764,24929.0,17258,11372,6463,26301
1112,22073,"Ouachita Parish, Louisiana",26310,21893.0,17084,10593,6168,20142
1113,22075,"Plaquemines Parish, Louisiana",30788,23378.0,15937,9500,5863,24925
1114,22077,"Pointe Coupee Parish, Louisiana",26972,21533.0,15387,8709,5233,21739
1115,22079,"Rapides Parish, Louisiana",27291,21982.0,16088,10014,5924,21367
1116,22081,"Red River Parish, Louisiana",21264,20044.0,12119,7213,4391,16873
1117,22083,"Richland Parish, Louisiana",20644,18060.0,12479,7791,4877,15767
1118,22085,"Sabine Parish, Louisiana",23260,20626.0,15199,8539,5096,18164
1119,22087,"St. Bernard Parish, Louisiana",22999,19448.0,16718,10512,6510,16489
1120,22089,"St. Charles Parish, Louisiana",34193,25728.0,19054,11901,6976,27217
1121,22091,"St. Helena Parish, Louisiana",23403,16387.0,12318,7199,4322,19081
1122,22093,"St. James Parish, Louisiana",28944,22509.0,14381,8959,5727,23217
1123,22095,"St. John The Baptist Parish, Louisiana",26683,20842.0,15445,10454,6372,20311
1124,22097,"St. Landry Parish, Louisiana",21416,17839.0,12042,7671,4752,16664
1125,22099,"St. Martin Parish, Louisiana",25515,20687.0,13619,7990,5234,20281
1126,22101,"St. Mary Parish, Louisiana",23306,20057.0,13399,8777,6789,16517
1127,22103,"St. Tammany Parish, Louisiana",35263,29282.0,22514,13605,7389,27874
1128,22105,"Tangipahoa Parish, Louisiana",25628,19788.0,14461,8150,5256,20372
1129,22107,"Tensas Parish, Louisiana",18435,15218.0,12622,7896,4623,13812
1130,22109,"Terrebonne Parish, Louisiana",27495,22931.0,16051,9505,6773,20722
1131,22111,"Union Parish, Louisiana",25598,20375.0,14819,8903,5002,20596
1132,22113,"Vermilion Parish, Louisiana",26503,21389.0,14201,8752,6106,20397
1133,22115,"Vernon Parish, Louisiana",25378,20191.0,14036,8414,4848,20530
1134,22117,"Washington Parish, Louisiana",21384,17120.0,12915,8292,5093,16291
1135,22119,"Webster Parish, Louisiana",20094,19254.0,15203,9191,5749,14345
1136,22121,"West Baton Rouge Parish, Louisiana",29195,22101.0,15773,10255,5984,23211
1137,22123,"West Carroll Parish, Louisiana",23400,16462.0,12302,7611,4308,19092
1138,22125,"West Feliciana Parish, Louisiana",27279,18118.0,16201,6796,3924,23355
1139,22127,"Winn Parish, Louisiana",22259,15833.0,11794,8728,4707,17552
1140,23001,"Androscoggin County, Maine",29947,22752.0,18734,12397,5623,24324
1141,23003,"Aroostook County, Maine",26774,20251.0,15033,10449,4826,21948
1142,23005,"Cumberland County, Maine",41822,31041.0,23949,15816,6694,35128
1143,23007,"Franklin County, Maine",29905,20838.0,15796,10830,5621,24284
1144,23009,"Hancock County, Maine",35345,26876.0,19809,12347,5411,29934
1145,23011,"Kennebec County, Maine",31486,24656.0,18520,12885,5966,25520
1146,23013,"Knox County, Maine",34420,25291.0,19981,12949,5659,28761
1147,23015,"Lincoln County, Maine",35114,28003.0,20760,13479,5607,29507
1148,23017,"Oxford County, Maine",26799,21254.0,16945,11373,5571,21228
1149,23019,"Penobscot County, Maine",29603,22977.0,17801,12231,5593,24010
1150,23021,"Piscataquis County, Maine",25511,19870.0,14374,9919,4990,20521
1151,23023,"Sagadahoc County, Maine",35226,26983.0,20378,13668,5924,29302
1152,23025,"Somerset County, Maine",25023,20709.0,15474,10471,4843,20180
1153,23027,"Waldo County, Maine",31091,22213.0,17438,11047,4689,26402
1154,23029,"Washington County, Maine",26049,19401.0,14119,9607,4581,21468
1155,23031,"York County, Maine",37009,27137.0,21225,14131,6212,30797
1156,24001,"Allegany County, Maryland",24776,20764.0,16780,11393,6049,18727
1157,24003,"Anne Arundel County, Maryland",48125,38660.0,27578,18509,8402,39723
1158,24005,"Baltimore County, Maryland",41089,33719.0,26167,18658,9044,32045
1159,24009,"Calvert County, Maryland",47066,36323.0,25410,17521,7354,39712
1160,24011,"Caroline County, Maryland",29814,24294.0,17275,11926,5946,23868
1161,24013,"Carroll County, Maryland",43183,33938.0,23829,16320,7483,35700
1162,24015,"Cecil County, Maryland",35887,28640.0,21384,14314,6598,29289
1163,24017,"Charles County, Maryland",42737,35780.0,24285,16555,7460,35277
1164,24019,"Dorchester County, Maryland",29860,25139.0,18929,12437,6200,23660
1165,24021,"Frederick County, Maryland",44273,35172.0,25404,16571,7479,36794
1166,24023,"Garrett County, Maryland",34006,23888.0,16219,10124,5212,28794
1167,24025,"Harford County, Maryland",42744,33559.0,24232,16612,7628,35116
1168,24027,"Howard County, Maryland",55873,45294.0,32402,22704,10065,45808
1169,24029,"Kent County, Maryland",37699,29536.0,21573,15488,6502,31197
1170,24031,"Montgomery County, Maryland",55643,47310.0,35684,25591,12335,43308
1171,24033,"Prince George's County, Maryland",38502,31215.0,23360,17391,8616,29886
1172,24035,"Queen Anne's County, Maryland",45228,35964.0,26364,17489,7027,38201
1173,24037,"St. Mary's County, Maryland",41430,34000.0,22662,14454,6601,34829
1174,24039,"Somerset County, Maryland",19507,16919.0,15965,10232,5284,14223
1175,24041,"Talbot County, Maryland",49193,37958.0,28164,18755,8217,40976
1176,24043,"Washington County, Maryland",31525,26588.0,20062,12970,6765,24760
1177,24045,"Wicomico County, Maryland",29049,25505.0,19171,13425,6666,22383
1178,24047,"Worcester County, Maryland",41055,31520.0,22505,14341,6572,34483
1179,24510,"Baltimore City, Maryland",32699,23333.0,16978,11994,5877,26822
1180,25001,"Barnstable County, Massachusetts",47315,35246.0,25318,16402,7428,39887
1181,25003,"Berkshire County, Massachusetts",37025,28300.0,21807,14857,6844,30181
1182,25005,"Bristol County, Massachusetts",36900,27736.0,20978,13853,6252,30648
1183,25007,"Dukes County, Massachusetts",43994,33390.0,26472,18280,7322,36672
1184,25009,"Essex County, Massachusetts",43948,33828.0,26358,17586,7673,36275
1185,25011,"Franklin County, Massachusetts",35919,27544.0,20672,13944,6648,29271
1186,25013,"Hampden County, Massachusetts",31483,24718.0,19541,14029,6731,24752
1187,25015,"Hampshire County, Massachusetts",36600,28367.0,21685,14414,6411,30189
1188,25017,"Middlesex County, Massachusetts",54433,40139.0,31199,20343,8439,45994
1189,25019,"Nantucket County, Massachusetts",57246,53410.0,31314,20591,9987,47259
1190,25021,"Norfolk County, Massachusetts",55860,42371.0,32484,21091,8828,47032
1191,25023,"Plymouth County, Massachusetts",45378,33333.0,24789,16523,6978,38400
1192,25025,"Suffolk County, Massachusetts",44723,30720.0,22766,15414,6557,38166
1193,25027,"Worcester County, Massachusetts",39113,30557.0,22983,15500,6908,32205
1194,26001,"Alcona County, Michigan",27171,19904.0,17653,9466,5111,22060
1195,26003,"Alger County, Michigan",21675,19858.0,18210,9669,5470,16205
1196,26005,"Allegan County, Michigan",30057,23108.0,19918,12498,6744,23313
1197,26007,"Alpena County, Michigan",25989,21140.0,17566,10930,5887,20102
1198,26009,"Antrim County, Michigan",32096,23912.0,19485,10856,5884,26212
1199,26011,"Arenac County, Michigan",25556,19073.0,16300,9730,5497,20059
1200,26013,"Baraga County, Michigan",23960,19107.0,15860,9021,5186,18774
1201,26015,"Barry County, Michigan",34002,24493.0,20636,12417,6965,27037
1202,26017,"Bay County, Michigan",28331,23049.0,19698,12597,7185,21146
1203,26019,"Benzie County, Michigan",31452,23649.0,18524,10415,5632,25820
1204,26021,"Berrien County, Michigan",30839,24025.0,19952,12636,6723,24116
1205,26023,"Branch County, Michigan",25754,19049.0,17552,11033,6449,19305
1206,26025,"Calhoun County, Michigan",27939,22166.0,19230,12729,7211,20728
1207,26027,"Cass County, Michigan",32835,22698.0,19474,12167,6481,26354
1208,26029,"Charlevoix County, Michigan",36132,28403.0,20130,11632,6005,30127
1209,26031,"Cheboygan County, Michigan",27589,23038.0,18088,9568,5449,22140
1210,26033,"Chippewa County, Michigan",28203,20309.0,15858,9468,5345,22858
1211,26035,"Clare County, Michigan",23067,18491.0,15922,9152,5298,17769
1212,26037,"Clinton County, Michigan",37513,27223.0,22913,14153,7362,30151
1213,26039,"Crawford County, Michigan",26628,21002.0,16903,9610,5621,21007
1214,26041,"Delta County, Michigan",27494,22064.0,18667,10810,5894,21600
1215,26043,"Dickinson County, Michigan",30798,23854.0,18516,12338,6257,24541
1216,26045,"Eaton County, Michigan",34282,25963.0,22411,14896,8076,26206
1217,26047,"Emmet County, Michigan",35306,28308.0,21070,12606,6389,28917
1218,26049,"Genesee County, Michigan",28696,22458.0,20883,13583,7951,20745
1219,26051,"Gladwin County, Michigan",26521,20571.0,16614,9482,5499,21022
1220,26053,"Gogebic County, Michigan",27877,19933.0,16169,9481,5184,22693
1221,26055,"Grand Traverse County, Michigan",35705,27091.0,22111,13289,6930,28775
1222,26057,"Gratiot County, Michigan",24623,18388.0,17118,10673,6042,18581
1223,26059,"Hillsdale County, Michigan",26265,20006.0,18255,11198,6121,20144
1224,26061,"Houghton County, Michigan",24881,18267.0,15078,9012,4970,19911
1225,26063,"Huron County, Michigan",28598,22098.0,17851,10089,5753,22845
1226,26065,"Ingham County, Michigan",30721,23883.0,21079,13740,7509,23212
1227,26067,"Ionia County, Michigan",25997,19386.0,17451,10896,6100,19897
1228,26069,"Iosco County, Michigan",25022,20513.0,17115,9556,5367,19655
1229,26071,"Iron County, Michigan",28556,19986.0,16506,9077,5586,22970
1230,26073,"Isabella County, Michigan",24297,18510.0,16242,9961,5591,18706
1231,26075,"Jackson County, Michigan",29141,21947.0,20171,12556,7003,22138
1232,26077,"Kalamazoo County, Michigan",33450,25138.0,21739,14548,7769,25681
1233,26079,"Kalkaska County, Michigan",25301,19770.0,16309,9502,5576,19725
1234,26081,"Kent County, Michigan",33629,24791.0,21629,14378,7522,26107
1235,26083,"Keweenaw County, Michigan",35765,21307.0,16769,8620,4782,30983
1236,26085,"Lake County, Michigan",22022,16084.0,14457,8195,4640,17382
1237,26087,"Lapeer County, Michigan",31927,25110.0,21462,13313,7089,24838
1238,26089,"Leelanau County, Michigan",39308,32194.0,24686,13307,6815,32493
1239,26091,"Lenawee County, Michigan",28695,22529.0,20186,12654,6957,21738
1240,26093,"Livingston County, Michigan",41039,31609.0,28069,17327,8323,32716
1241,26095,"Luce County, Michigan",24337,17195.0,16828,9264,5301,19036
1242,26097,"Mackinac County, Michigan",30872,22170.0,17777,9751,5274,25598
1243,26099,"Macomb County, Michigan",33327,26524.0,24446,16187,8655,24672
1244,26101,"Manistee County, Michigan",28365,21612.0,17204,10118,6182,22183
1245,26103,"Marquette County, Michigan",28537,23347.0,18070,11025,6187,22350
1246,26105,"Mason County, Michigan",29102,21760.0,17713,10848,6192,22910
1247,26107,"Mecosta County, Michigan",23748,18745.0,16372,9271,5230,18518
1248,26109,"Menominee County, Michigan",28517,21624.0,16909,10336,5585,22932
1249,26111,"Midland County, Michigan",36338,28363.0,23383,15615,8052,28286
1250,26113,"Missaukee County, Michigan",25146,19560.0,16072,9139,5151,19995
1251,26115,"Monroe County, Michigan",33202,25520.0,22458,13893,7356,25846
1252,26117,"Montcalm County, Michigan",25010,18569.0,16183,10081,5905,19105
1253,26119,"Montmorency County, Michigan",25221,19102.0,16493,9307,4838,20383
1254,26121,"Muskegon County, Michigan",26655,19719.0,17967,11345,6358,20297
1255,26123,"Newaygo County, Michigan",25970,20870.0,16976,10307,5696,20274
1256,26125,"Oakland County, Michigan",46075,36138.0,32534,21125,10658,35417
1257,26127,"Oceana County, Michigan",25028,18402.0,15878,9582,5627,19401
1258,26129,"Ogemaw County, Michigan",24463,18321.0,15768,8991,5001,19462
1259,26131,"Ontonagon County, Michigan",24833,21448.0,16695,10939,5599,19234
1260,26133,"Osceola County, Michigan",23238,17861.0,15632,9258,5252,17986
1261,26135,"Oscoda County, Michigan",25127,18524.0,15697,8719,5109,20018
1262,26137,"Otsego County, Michigan",27904,22568.0,19810,11366,5933,21971
1263,26139,"Ottawa County, Michigan",33005,25045.0,21676,14347,7198,25807
1264,26141,"Presque Isle County, Michigan",30068,20870.0,17363,9654,5522,24546
1265,26143,"Roscommon County, Michigan",27491,20194.0,17837,9709,5411,22080
1266,26145,"Saginaw County, Michigan",28628,21662.0,19438,12355,7263,21365
1267,26147,"St. Clair County, Michigan",31724,23828.0,21582,13257,7080,24644
1268,26149,"St. Joseph County, Michigan",26810,20192.0,18247,12039,6473,20337
1269,26151,"Sanilac County, Michigan",27350,19645.0,17089,10330,5932,21418
1270,26153,"Schoolcraft County, Michigan",27936,20455.0,17137,9740,5283,22653
1271,26155,"Shiawassee County, Michigan",29544,21869.0,19229,12244,6948,22596
1272,26157,"Tuscola County, Michigan",26905,19937.0,17985,11543,6500,20405
1273,26159,"Van Buren County, Michigan",28774,22002.0,17878,11233,6108,22666
1274,26161,"Washtenaw County, Michigan",42855,31316.0,27173,17115,8703,34152
1275,26163,"Wayne County, Michigan",28403,22125.0,20058,13016,7608,20795
1276,26165,"Wexford County, Michigan",26554,19952.0,17144,10952,5874,20680
1277,27001,"Aitkin County, Minnesota",30585,22966.0,17848,9281,4773,25812
1278,27003,"Anoka County, Minnesota",37804,29347.0,23297,14554,7636,30168
1279,27005,"Becker County, Minnesota",34226,24385.0,17085,9889,5464,28762
1280,27007,"Beltrami County, Minnesota",26563,21016.0,15497,8938,5161,21402
1281,27009,"Benton County, Minnesota",31515,23648.0,19008,11018,5743,25772
1282,27011,"Big Stone County, Minnesota",30588,23746.0,15708,9575,5490,25098
1283,27013,"Blue Earth County, Minnesota",29965,23691.0,18712,11125,6608,23357
1284,27015,"Brown County, Minnesota",30900,24591.0,19535,11244,6299,24601
1285,27017,"Carlton County, Minnesota",30619,23932.0,18073,10878,6013,24606
1286,27019,"Carver County, Minnesota",48492,35807.0,28486,16116,7714,40778
1287,27021,"Cass County, Minnesota",30979,24348.0,17189,8991,4804,26175
1288,27023,"Chippewa County, Minnesota",30957,23610.0,18039,11067,6040,24917
1289,27025,"Chisago County, Minnesota",35869,26576.0,21013,12526,6506,29363
1290,27027,"Clay County, Minnesota",31233,23011.0,17557,10836,6513,24720
1291,27029,"Clearwater County, Minnesota",27548,20913.0,15694,8359,4437,23111
1292,27031,"Cook County, Minnesota",36941,28873.0,21775,12067,6743,30198
1293,27033,"Cottonwood County, Minnesota",27709,23162.0,16647,10335,6448,21261
1294,27035,"Crow Wing County, Minnesota",32962,24282.0,19174,10911,5632,27330
1295,27037,"Dakota County, Minnesota",42588,34142.0,27008,17237,8578,34010
1296,27039,"Dodge County, Minnesota",36008,26969.0,19259,11932,6313,29695
1297,27041,"Douglas County, Minnesota",36559,25633.0,18850,10264,5636,30923
1298,27043,"Faribault County, Minnesota",30600,22667.0,17193,11276,6484,24116
1299,27045,"Fillmore County, Minnesota",31083,23758.0,17067,10146,5655,25428
1300,27047,"Freeborn County, Minnesota",30760,23645.0,18325,11452,6754,24006
1301,27049,"Goodhue County, Minnesota",35767,27472.0,21934,12892,6839,28928
1302,27051,"Grant County, Minnesota",33407,23233.0,17131,9622,5628,27779
1303,27053,"Hennepin County, Minnesota",47618,35902.0,28789,18496,9403,38215
1304,27055,"Houston County, Minnesota",33546,24865.0,18826,11587,5945,27601
1305,27057,"Hubbard County, Minnesota",30467,24413.0,18115,9527,5168,25299
1306,27059,"Isanti County, Minnesota",34591,25165.0,20348,11909,6089,28502
1307,27061,"Itasca County, Minnesota",30504,23465.0,17717,10541,6148,24356
1308,27063,"Jackson County, Minnesota",36928,25144.0,17499,11287,6112,30816
1309,27065,"Kanabec County, Minnesota",29055,21304.0,17741,9887,5645,23410
1310,27067,"Kandiyohi County, Minnesota",31778,25844.0,19627,11574,6410,25368
1311,27069,"Kittson County, Minnesota",29717,25030.0,16525,11050,5877,23840
1312,27071,"Koochiching County, Minnesota",31453,24576.0,19167,11732,6062,25391
1313,27073,"Lac Qui Parle County, Minnesota",34091,24291.0,17399,10368,5727,28364
1314,27075,"Lake County, Minnesota",35671,26087.0,19761,11415,7900,27771
1315,27077,"Lake Of The Woods County, Minnesota",27833,27192.0,16976,10623,5175,22658
1316,27079,"Le Sueur County, Minnesota",34904,25958.0,20151,11792,6407,28497
1317,27081,"Lincoln County, Minnesota",30178,24922.0,16009,9616,4772,25406
1318,27083,"Lyon County, Minnesota",30706,23755.0,18013,11121,6113,24593
1319,27085,"Mcleod County, Minnesota",33628,27590.0,20137,12689,6545,27083
1320,27087,"Mahnomen County, Minnesota",21198,17999.0,13438,7737,4176,17022
1321,27089,"Marshall County, Minnesota",30934,24552.0,16317,9675,5225,25709
1322,27091,"Martin County, Minnesota",31505,25321.0,18529,11387,6908,24597
1323,27093,"Meeker County, Minnesota",32412,23839.0,18628,10843,5936,26476
1324,27095,"Mille Lacs County, Minnesota",29149,21744.0,17656,10167,5497,23652
1325,27097,"Morrison County, Minnesota",30293,22934.0,16566,9666,4797,25496
1326,27099,"Mower County, Minnesota",29828,23740.0,19795,11599,7027,22801
1327,27101,"Murray County, Minnesota",32791,24045.0,17936,10871,5623,27168
1328,27103,"Nicollet County, Minnesota",38120,25656.0,20517,12358,6487,31633
1329,27105,"Nobles County, Minnesota",26290,20953.0,16987,10860,6314,19976
1330,27107,"Norman County, Minnesota",30915,22817.0,15895,9948,5736,25179
1331,27109,"Olmsted County, Minnesota",42470,32704.0,24939,16214,8078,34392
1332,27111,"Otter Tail County, Minnesota",32702,23445.0,18014,10467,5628,27074
1333,27113,"Pennington County, Minnesota",31340,22687.0,17346,10426,6206,25134
1334,27115,"Pine County, Minnesota",27607,21328.0,17445,9538,5093,22514
1335,27117,"Pipestone County, Minnesota",30084,22289.0,16450,10050,5529,24555
1336,27119,"Polk County, Minnesota",29828,23105.0,17279,10199,5985,23843
1337,27121,"Pope County, Minnesota",35244,25935.0,19032,9465,5287,29957
1338,27123,"Ramsey County, Minnesota",36598,28956.0,23536,15645,8307,28291
1339,27125,"Red Lake County, Minnesota",30190,23171.0,15372,8963,4674,25516
1340,27127,"Redwood County, Minnesota",29086,23548.0,18903,10489,5938,23148
1341,27129,"Renville County, Minnesota",31243,23956.0,17770,10795,6026,25217
1342,27131,"Rice County, Minnesota",31792,24678.0,19695,11936,6236,25556
1343,27133,"Rock County, Minnesota",33698,23079.0,17411,11383,6134,27564
1344,27135,"Roseau County, Minnesota",31452,22975.0,17053,10280,5293,26159
1345,27137,"St. Louis County, Minnesota",32890,25014.0,18982,11833,7063,25827
1346,27139,"Scott County, Minnesota",43890,33612.0,26418,15341,7742,36148
1347,27141,"Sherburne County, Minnesota",36022,27376.0,21322,13147,6338,29684
1348,27143,"Sibley County, Minnesota",32471,24073.0,18004,10899,5980,26491
1349,27145,"Stearns County, Minnesota",31574,24816.0,19211,11620,5759,25815
1350,27147,"Steele County, Minnesota",34648,25062.0,20328,12993,6688,27960
1351,27149,"Stevens County, Minnesota",35551,24585.0,17569,9814,5619,29932
1352,27151,"Swift County, Minnesota",33416,21571.0,16360,9222,5252,28164
1353,27153,"Todd County, Minnesota",26427,21014.0,15658,8535,4706,21721
1354,27155,"Traverse County, Minnesota",32983,24188.0,16378,9882,5796,27187
1355,27157,"Wabasha County, Minnesota",35527,26282.0,19664,11862,6168,29359
1356,27159,"Wadena County, Minnesota",24603,19344.0,15146,8640,4820,19783
1357,27161,"Waseca County, Minnesota",31563,23121.0,18631,11514,6534,25029
1358,27163,"Washington County, Minnesota",46842,36248.0,28148,17435,8176,38666
1359,27165,"Watonwan County, Minnesota",28633,22334.0,16413,10658,6289,22344
1360,27167,"Wilkin County, Minnesota",32868,24447.0,16873,10108,6188,26680
1361,27169,"Winona County, Minnesota",31384,21864.0,18077,11323,6159,25225
1362,27171,"Wright County, Minnesota",37416,28454.0,21844,12687,6526,30890
1363,27173,"Yellow Medicine County, Minnesota",31033,23171.0,17120,10513,5595,25438
1364,28001,"Adams County, Mississippi",18551,17473.0,15778,9469,5276,13275
1365,28003,"Alcorn County, Mississippi",22887,17954.0,15418,9301,5778,17109
1366,28005,"Amite County, Mississippi",22414,16861.0,14048,8268,4327,18087
1367,28007,"Attala County, Mississippi",22695,17659.0,13782,7685,4214,18481
1368,28009,"Benton County, Mississippi",21113,14998.0,12212,6982,4153,16960
1369,28011,"Bolivar County, Mississippi",21420,16051.0,12088,6889,4004,17416
1370,28013,"Calhoun County, Mississippi",20384,15183.0,15106,8806,4353,16031
1371,28015,"Carroll County, Mississippi",26146,16025.0,15744,8241,4040,22106
1372,28017,"Chickasaw County, Mississippi",19113,15985.0,13279,8725,4547,14566
1373,28019,"Choctaw County, Mississippi",24353,16545.0,13474,8076,4117,20236
1374,28021,"Claiborne County, Mississippi",17829,12571.0,11244,5932,4220,13609
1375,28023,"Clarke County, Mississippi",23546,16467.0,14288,8987,4896,18650
1376,28025,"Clay County, Mississippi",22402,17604.0,14512,9224,4868,17534
1377,28027,"Coahoma County, Mississippi",19649,15687.0,12558,7197,4129,15520
1378,28029,"Copiah County, Mississippi",24304,17473.0,12408,7815,4514,19790
1379,28031,"Covington County, Mississippi",19537,17713.0,14506,7847,4460,15077
1380,28033,"De Soto County, Mississippi",30573,24531.0,20468,12509,5889,24684
1381,28035,"Forrest County, Mississippi",23590,19272.0,15160,9765,5365,18225
1382,28037,"Franklin County, Mississippi",22723,21583.0,13643,7426,4374,18349
1383,28039,"George County, Mississippi",22333,19452.0,14337,8000,4890,17443
1384,28041,"Greene County, Mississippi",16548,14064.0,11868,6882,3855,12693
1385,28043,"Grenada County, Mississippi",24625,19701.0,13786,9125,5035,19590
1386,28045,"Hancock County, Mississippi",32486,21935.0,17748,10180,5705,26781
1387,28047,"Harrison County, Mississippi",26419,22880.0,18024,10434,5807,20612
1388,28049,"Hinds County, Mississippi",24463,20676.0,17785,12222,6728,17735
1389,28051,"Holmes County, Mississippi",16898,11585.0,10683,5969,3379,13519
1390,28053,"Humphreys County, Mississippi",24481,13282.0,10926,7201,3969,20512
1391,28055,"Issaquena County, Mississippi",19785,11810.0,10581,6412,4538,15247
1392,28057,"Itawamba County, Mississippi",26024,18517.0,14956,9476,4854,21170
1393,28059,"Jackson County, Mississippi",28066,22655.0,17768,11246,6122,21944
1394,28061,"Jasper County, Mississippi",22252,18268.0,12889,7524,4093,18159
1395,28063,"Jefferson County, Mississippi",16602,12534.0,9709,5349,3262,13340
1396,28065,"Jefferson Davis County, Mississippi",21205,15120.0,11974,7303,4401,16804
1397,28067,"Jones County, Mississippi",23355,18632.0,14820,9663,5484,17871
1398,28069,"Kemper County, Mississippi",19272,12903.0,11985,8033,3751,15521
1399,28071,"Lafayette County, Mississippi",28567,21267.0,16406,9196,5169,23398
1400,28073,"Lamar County, Mississippi",32518,26052.0,18849,10619,5541,26977
1401,28075,"Lauderdale County, Mississippi",24892,20116.0,16026,10649,5804,19088
1402,28077,"Lawrence County, Mississippi",23215,19142.0,14469,8294,5266,17949
1403,28079,"Leake County, Mississippi",21050,14617.0,13365,7279,4012,17038
1404,28081,"Lee County, Mississippi",27993,21831.0,18956,11702,5770,22223
1405,28083,"Leflore County, Mississippi",19672,12957.0,12553,9003,4378,15294
1406,28085,"Lincoln County, Mississippi",23586,20620.0,13961,9134,5085,18501
1407,28087,"Lowndes County, Mississippi",26439,21273.0,16514,11108,5299,21140
1408,28089,"Madison County, Mississippi",41224,31517.0,23469,12020,4995,36229
1409,28091,"Marion County, Mississippi",20769,17549.0,12301,8490,4756,16013
1410,28093,"Marshall County, Mississippi",22819,16825.0,14028,7599,4010,18809
1411,28095,"Monroe County, Mississippi",23793,18884.0,14072,8979,4752,19041
1412,28097,"Montgomery County, Mississippi",21912,16584.0,14040,7660,4101,17811
1413,28099,"Neshoba County, Mississippi",20587,17609.0,14964,8249,4666,15921
1414,28101,"Newton County, Mississippi",24295,16727.0,14008,8923,4735,19560
1415,28103,"Noxubee County, Mississippi",18206,12759.0,12018,6654,3696,14510
1416,28105,"Oktibbeha County, Mississippi",23827,19356.0,14998,9166,4776,19051
1417,28107,"Panola County, Mississippi",22357,15987.0,13075,7537,4196,18161
1418,28109,"Pearl River County, Mississippi",25483,20014.0,15160,9418,5137,20346
1419,28111,"Perry County, Mississippi",24258,18238.0,12837,7418,4400,19858
1420,28113,"Pike County, Mississippi",18679,17620.0,14040,8119,4741,13938
1421,28115,"Pontotoc County, Mississippi",22605,17820.0,15658,9143,4983,17622
1422,28117,"Prentiss County, Mississippi",21258,17068.0,14131,8947,4839,16419
1423,28119,"Quitman County, Mississippi",15852,13080.0,10817,6450,3838,12014
1424,28121,"Rankin County, Mississippi",32106,26637.0,20412,12749,6447,25659
1425,28123,"Scott County, Mississippi",21357,16608.0,14013,8187,4614,16743
1426,28125,"Sharkey County, Mississippi",20584,14322.0,11396,6032,4032,16552
1427,28127,"Simpson County, Mississippi",24170,18397.0,13344,8284,4667,19503
1428,28129,"Smith County, Mississippi",24423,18686.0,14752,8799,4577,19846
1429,28131,"Stone County, Mississippi",24093,21691.0,14693,8816,4833,19260
1430,28133,"Sunflower County, Mississippi",16437,11993.0,11365,7067,3958,12479
1431,28135,"Tallahatchie County, Mississippi",17942,12687.0,10749,6180,3770,14172
1432,28137,"Tate County, Mississippi",25245,18318.0,16154,9212,4753,20492
1433,28139,"Tippah County, Mississippi",18816,16365.0,14041,8747,4327,14489
1434,28141,"Tishomingo County, Mississippi",21313,17017.0,15395,8735,5397,15916
1435,28143,"Tunica County, Mississippi",17197,15711.0,11978,6449,3251,13946
1436,28145,"Union County, Mississippi",23050,17945.0,15700,9735,4958,18092
1437,28147,"Walthall County, Mississippi",21092,16157.0,12563,7263,4598,16494
1438,28149,"Warren County, Mississippi",27058,22079.0,17527,10861,6268,20790
1439,28151,"Washington County, Mississippi",22181,15946.0,13430,8704,4670,17511
1440,28153,"Wayne County, Mississippi",23892,17099.0,12757,7545,4331,19561
1441,28155,"Webster County, Mississippi",23773,17888.0,14109,8354,4857,18916
1442,28157,"Wilkinson County, Mississippi",18074,14333.0,10868,6670,3600,14474
1443,28159,"Winston County, Mississippi",25838,17244.0,14548,8907,4607,21231
1444,28161,"Yalobusha County, Mississippi",21069,16623.0,14953,8049,4432,16637
1445,28163,"Yazoo County, Mississippi",17341,14339.0,12062,7786,4562,12779
1446,29001,"Adair County, Missouri",24509,17098.0,15484,9197,5903,18606
1447,29003,"Andrew County, Missouri",29671,24009.0,19375,10984,6266,23405
1448,29005,"Atchison County, Missouri",30927,23659.0,16956,10042,6235,24692
1449,29007,"Audrain County, Missouri",23810,18800.0,16441,11310,6523,17287
1450,29009,"Barry County, Missouri",26463,19363.0,14980,9465,5329,21134
1451,29011,"Barton County, Missouri",26112,19117.0,13987,10229,5417,20695
1452,29013,"Bates County, Missouri",27020,19056.0,15477,9598,5938,21082
1453,29015,"Benton County, Missouri",27310,19955.0,15457,9112,5686,21624
1454,29017,"Bollinger County, Missouri",21813,18172.0,13641,8757,4359,17454
1455,29019,"Boone County, Missouri",32050,25124.0,19844,12707,6942,25108
1456,29021,"Buchanan County, Missouri",26854,21638.0,17882,11193,6461,20393
1457,29023,"Butler County, Missouri",22611,19368.0,15721,9000,5044,17567
1458,29025,"Caldwell County, Missouri",24934,19499.0,15343,9491,5624,19310
1459,29027,"Callaway County, Missouri",26460,22602.0,17005,11024,6290,20170
1460,29029,"Camden County, Missouri",30402,25509.0,20197,12403,5891,24511
1461,29031,"Cape Girardeau County, Missouri",27483,23014.0,18593,11858,6561,20922
1462,29033,"Carroll County, Missouri",26629,25021.0,15522,10102,6127,20502
1463,29035,"Carter County, Missouri",23382,15881.0,13349,7470,4281,19101
1464,29037,"Cass County, Missouri",33883,26326.0,21073,12991,7187,26696
1465,29039,"Cedar County, Missouri",24397,16432.0,14356,8864,5331,19066
1466,29041,"Chariton County, Missouri",25177,19978.0,15515,10589,6287,18890
1467,29043,"Christian County, Missouri",30078,23720.0,18422,10862,5870,24208
1468,29045,"Clark County, Missouri",27606,19114.0,15988,8849,5708,21898
1469,29047,"Clay County, Missouri",34723,28204.0,23144,15369,8351,26372
1470,29049,"Clinton County, Missouri",28461,24629.0,19056,11492,6434,22027
1471,29051,"Cole County, Missouri",31790,25935.0,20739,13918,7178,24612
1472,29053,"Cooper County, Missouri",24237,19234.0,15648,10006,5937,18300
1473,29055,"Crawford County, Missouri",23082,17317.0,14825,9284,5273,17809
1474,29057,"Dade County, Missouri",25237,16638.0,14254,9490,5629,19608
1475,29059,"Dallas County, Missouri",21883,18400.0,15106,8530,4899,16984
1476,29061,"Daviess County, Missouri",24987,19900.0,15953,9008,5990,18997
1477,29063,"De Kalb County, Missouri",20810,16916.0,12687,9047,5569,15241
1478,29065,"Dent County, Missouri",23254,18111.0,14463,9033,5059,18195
1479,29067,"Douglas County, Missouri",23883,15117.0,13785,8899,4375,19508
1480,29069,"Dunklin County, Missouri",22879,16619.0,13561,9028,4846,18033
1481,29071,"Franklin County, Missouri",31133,23365.0,19705,11606,6283,24850
1482,29073,"Gasconade County, Missouri",29614,21240.0,17319,10774,5901,23713
1483,29075,"Gentry County, Missouri",25814,19021.0,15879,9535,5376,20438
1484,29077,"Greene County, Missouri",28308,23443.0,19185,12468,6668,21640
1485,29079,"Grundy County, Missouri",25928,18148.0,15432,9858,5736,20192
1486,29081,"Harrison County, Missouri",21506,18967.0,14192,10118,5686,15820
1487,29083,"Henry County, Missouri",27483,20304.0,16468,9835,6206,21277
1488,29085,"Hickory County, Missouri",19905,18215.0,13536,8583,4600,15305
1489,29087,"Holt County, Missouri",28497,21666.0,15876,9757,5579,22918
1490,29089,"Howard County, Missouri",25159,21829.0,15198,9854,5780,19379
1491,29091,"Howell County, Missouri",20375,17135.0,13959,8776,4661,15714
1492,29093,"Iron County, Missouri",21769,17200.0,14227,8232,5005,16764
1493,29095,"Jackson County, Missouri",32462,25213.0,20788,13712,7610,24852
1494,29097,"Jasper County, Missouri",24508,19899.0,16227,10621,6025,18483
1495,29099,"Jefferson County, Missouri",30800,24586.0,19435,12226,6642,24158
1496,29101,"Johnson County, Missouri",26327,20405.0,16037,10202,5593,20734
1497,29103,"Knox County, Missouri",20941,18481.0,13075,9048,5525,15416
1498,29105,"Laclede County, Missouri",23296,19858.0,15572,9522,5287,18009
1499,29107,"Lafayette County, Missouri",30450,23043.0,18493,11470,6559,23891
1500,29109,"Lawrence County, Missouri",22850,18777.0,15399,9672,5187,17663
1501,29111,"Lewis County, Missouri",23054,18973.0,14746,9298,5648,17406
1502,29113,"Lincoln County, Missouri",28299,21862.0,17149,11123,6124,22175
1503,29115,"Linn County, Missouri",26981,20742.0,15378,9391,6103,20878
1504,29117,"Livingston County, Missouri",24928,20295.0,16685,11316,6561,18367
1505,29119,"Mcdonald County, Missouri",20964,17070.0,13175,8409,4769,16195
1506,29121,"Macon County, Missouri",22876,18411.0,16189,9976,6095,16781
1507,29123,"Madison County, Missouri",26063,17239.0,13215,8560,4867,21196
1508,29125,"Maries County, Missouri",26756,19155.0,15662,9426,5077,21679
1509,29127,"Marion County, Missouri",25708,20718.0,16964,10110,6217,19491
1510,29129,"Mercer County, Missouri",23272,19031.0,15140,9132,5163,18109
1511,29131,"Miller County, Missouri",26251,18202.0,15144,9356,5314,20937
1512,29133,"Mississippi County, Missouri",18655,15927.0,13038,8945,4943,13712
1513,29135,"Moniteau County, Missouri",23371,19267.0,16609,10172,5683,17688
1514,29137,"Monroe County, Missouri",25180,19834.0,14695,9444,5573,19607
1515,29139,"Montgomery County, Missouri",25976,19634.0,15092,10128,5648,20328
1516,29141,"Morgan County, Missouri",25137,18789.0,15950,9867,5125,20012
1517,29143,"New Madrid County, Missouri",22513,18811.0,14204,9034,4742,17771
1518,29145,"Newton County, Missouri",30425,20832.0,17502,11136,5666,24759
1519,29147,"Nodaway County, Missouri",23869,18909.0,15384,9268,5714,18155
1520,29149,"Oregon County, Missouri",18775,15093.0,12812,7622,4120,14655
1521,29151,"Osage County, Missouri",34195,21484.0,17245,10032,5454,28741
1522,29153,"Ozark County, Missouri",20479,17298.0,14133,8611,4520,15959
1523,29155,"Pemiscot County, Missouri",21634,15841.0,12968,7709,4431,17203
1524,29157,"Perry County, Missouri",27294,22200.0,16554,10370,5194,22100
1525,29159,"Pettis County, Missouri",25758,19351.0,16251,11010,6395,19363
1526,29161,"Phelps County, Missouri",25217,20817.0,16084,10531,5726,19491
1527,29163,"Pike County, Missouri",22720,18769.0,14462,9887,6055,16665
1528,29165,"Platte County, Missouri",41193,34037.0,26356,16737,8687,32506
1529,29167,"Polk County, Missouri",23591,18138.0,13645,8873,5110,18481
1530,29169,"Pulaski County, Missouri",25098,19800.0,14586,9159,4935,20163
1531,29171,"Putnam County, Missouri",28240,20005.0,14647,9025,5235,23005
1532,29173,"Ralls County, Missouri",26913,22605.0,16456,10554,6257,20656
1533,29175,"Randolph County, Missouri",22587,17049.0,15010,10855,5982,16605
1534,29177,"Ray County, Missouri",32165,25244.0,18685,11213,6676,25489
1535,29179,"Reynolds County, Missouri",23197,16964.0,13065,8667,4654,18543
1536,29181,"Ripley County, Missouri",19106,15115.0,12889,7295,3917,15189
1537,29183,"St. Charles County, Missouri",40738,30664.0,23592,15366,7679,33059
1538,29185,"St. Clair County, Missouri",23158,18309.0,14025,9097,4991,18167
1539,29186,"Ste. Genevieve County, Missouri",33049,22665.0,17283,10775,5863,27186
1540,29187,"St. Francois County, Missouri",22577,18852.0,15273,9585,5534,17043
1541,29189,"St. Louis County, Missouri",42682,33344.0,27595,18625,9215,33467
1542,29195,"Saline County, Missouri",23692,18581.0,16132,10624,5994,17698
1543,29197,"Schuyler County, Missouri",19482,18410.0,15850,9059,5255,14227
1544,29199,"Scotland County, Missouri",25956,19895.0,14474,8581,5411,20545
1545,29201,"Scott County, Missouri",26193,19566.0,15620,9907,5565,20628
1546,29203,"Shannon County, Missouri",17782,15309.0,11492,7720,4097,13685
1547,29205,"Shelby County, Missouri",23791,18056.0,15632,9545,5475,18316
1548,29207,"Stoddard County, Missouri",22587,20911.0,14656,9644,5125,17462
1549,29209,"Stone County, Missouri",28897,21748.0,18036,11173,5510,23387
1550,29211,"Sullivan County, Missouri",23829,16633.0,13392,9193,5211,18618
1551,29213,"Taney County, Missouri",24659,21474.0,17267,11198,5805,18854
1552,29215,"Texas County, Missouri",20541,15790.0,13799,8507,4699,15842
1553,29217,"Vernon County, Missouri",23553,18314.0,15047,9587,5893,17660
1554,29219,"Warren County, Missouri",31308,24358.0,19690,11640,6793,24515
1555,29221,"Washington County, Missouri",23740,16867.0,12934,7650,4539,19201
1556,29223,"Wayne County, Missouri",20449,17105.0,13434,8434,4484,15965
1557,29225,"Webster County, Missouri",24139,18699.0,14502,9116,5304,18835
1558,29227,"Worth County, Missouri",26866,18229.0,14367,8475,5108,21758
1559,29229,"Wright County, Missouri",18858,16413.0,13135,7692,4836,14022
1560,29510,"St. Louis City, Missouri",31930,21406.0,16108,10798,5879,26051
1561,30001,"Beaverhead County, Montana",28798,21110.0,15621,10376,5913,22885
1562,30003,"Big Horn County, Montana",19109,15066.0,10792,7148,4857,14252
1563,30005,"Blaine County, Montana",20586,16813.0,12101,8290,5035,15551
1564,30007,"Broadwater County, Montana",31573,19606.0,16237,10125,5593,25980
1565,30009,"Carbon County, Montana",34751,24983.0,17204,10727,5728,29023
1566,30011,"Carter County, Montana",27759,20681.0,13280,10670,5102,22657
1567,30013,"Cascade County, Montana",30572,22963.0,17566,12011,6959,23613
1568,30015,"Chouteau County, Montana",26243,20202.0,14851,11290,6684,19559
1569,30017,"Custer County, Montana",31267,21676.0,15876,10310,6514,24753
1570,30019,"Daniels County, Montana",33614,24737.0,16055,9963,6006,27608
1571,30021,"Dawson County, Montana",30821,24602.0,15368,10629,6649,24172
1572,30023,"Deer Lodge County, Montana",26207,21921.0,15580,9444,6220,19987
1573,30025,"Fallon County, Montana",36409,26819.0,16014,10308,6589,29820
1574,30027,"Fergus County, Montana",28211,22295.0,15808,10995,5639,22572
1575,30029,"Flathead County, Montana",32242,24721.0,18112,11718,6695,25547
1576,30031,"Gallatin County, Montana",38885,27423.0,19074,12252,6459,32426
1577,30033,"Garfield County, Montana",29149,22424.0,13930,9843,5499,23650
1578,30035,"Glacier County, Montana",18440,17053.0,11597,7458,5362,13078
1579,30037,"Golden Valley County, Montana",30053,19319.0,13573,8505,4475,25578
1580,30039,"Granite County, Montana",32401,23222.0,16636,10049,5845,26556
1581,30041,"Hill County, Montana",23922,21420.0,14935,11121,6972,16950
1582,30043,"Jefferson County, Montana",33716,26437.0,18250,13233,6324,27392
1583,30045,"Judith Basin County, Montana",33720,24029.0,14291,12060,5870,27850
1584,30047,"Lake County, Montana",26889,20164.0,15173,9274,5410,21479
1585,30049,"Lewis And Clark County, Montana",36485,25894.0,18763,12342,7264,29221
1586,30051,"Liberty County, Montana",46198,19097.0,14882,10544,6897,39301
1587,30053,"Lincoln County, Montana",25169,19626.0,13923,9813,5761,19408
1588,30055,"Mccone County, Montana",31242,23265.0,15162,9347,4746,26496
1589,30057,"Madison County, Montana",35668,32205.0,16944,10718,5585,30083
1590,30059,"Meagher County, Montana",26392,17318.0,15019,9201,5854,20538
1591,30061,"Mineral County, Montana",28644,19209.0,15166,9440,5953,22691
1592,30063,"Missoula County, Montana",33358,24343.0,17808,11944,7256,26102
1593,30065,"Musselshell County, Montana",27843,20875.0,15389,8941,5347,22496
1594,30067,"Park County, Montana",35446,24717.0,17704,11378,6607,28839
1595,30069,"Petroleum County, Montana",28220,21008.0,15986,9876,5502,22718
1596,30071,"Phillips County, Montana",26825,24227.0,15058,10793,5159,21666
1597,30073,"Pondera County, Montana",27114,18989.0,14276,9811,6661,20453
1598,30075,"Powder River County, Montana",33170,21543.0,15351,12722,6523,26647
1599,30077,"Powell County, Montana",25002,17849.0,13816,9978,5662,19340
1600,30079,"Prairie County, Montana",28892,21296.0,14422,8497,4288,24604
1601,30081,"Ravalli County, Montana",31545,23908.0,17935,10130,5678,25867
1602,30083,"Richland County, Montana",30330,26888.0,16006,10091,6897,23433
1603,30085,"Roosevelt County, Montana",18669,17821.0,11347,7751,5741,12928
1604,30087,"Rosebud County, Montana",25557,19844.0,15032,10415,6180,19377
1605,30089,"Sanders County, Montana",26103,18472.0,14593,9459,5522,20581
1606,30091,"Sheridan County, Montana",37958,26537.0,16038,10001,6779,31179
1607,30093,"Silver Bow County, Montana",28221,21357.0,17009,11364,6547,21674
1608,30095,"Stillwater County, Montana",35387,27168.0,18468,10975,5582,29805
1609,30097,"Sweet Grass County, Montana",27553,22785.0,17880,10838,5689,21864
1610,30099,"Teton County, Montana",27985,20509.0,14635,10772,6070,21915
1611,30101,"Toole County, Montana",30213,20464.0,14731,11375,6659,23554
1612,30103,"Treasure County, Montana",33685,20882.0,14392,10244,5207,28478
1613,30105,"Valley County, Montana",28440,24305.0,16246,10529,6187,22253
1614,30107,"Wheatland County, Montana",21409,18474.0,11954,8656,5636,15773
1615,30109,"Wibaux County, Montana",26405,22579.0,16121,9338,4908,21497
1616,30111,"Yellowstone County, Montana",37261,26152.0,19303,12416,7600,29661
1617,31001,"Adams County, Nebraska",30344,23084.0,18308,12650,6908,23436
1618,31003,"Antelope County, Nebraska",27217,20419.0,14601,9221,4882,22335
1619,31005,"Arthur County, Nebraska",25277,19722.0,15810,9094,6598,18679
1620,31007,"Banner County, Nebraska",30628,22042.0,17149,9120,5573,25055
1621,31009,"Blaine County, Nebraska",29748,20586.0,12323,9681,4691,25057
1622,31011,"Boone County, Nebraska",32850,22790.0,15831,10062,5673,27177
1623,31013,"Box Butte County, Nebraska",29447,23434.0,18407,11880,7625,21822
1624,31015,"Boyd County, Nebraska",31863,21003.0,13840,8979,4542,27321
1625,31017,"Brown County, Nebraska",29420,17330.0,15924,9209,5484,23936
1626,31019,"Buffalo County, Nebraska",30605,22616.0,17510,11190,6446,24159
1627,31021,"Burt County, Nebraska",31252,23302.0,16654,10030,6085,25167
1628,31023,"Butler County, Nebraska",33418,22494.0,16394,11662,5912,27506
1629,31025,"Cass County, Nebraska",34863,27584.0,20156,11792,6596,28267
1630,31027,"Cedar County, Nebraska",30663,20595.0,15514,8978,5274,25389
1631,31029,"Chase County, Nebraska",30850,22730.0,17490,10011,5452,25398
1632,31031,"Cherry County, Nebraska",30169,22601.0,15943,10758,6797,23372
1633,31033,"Cheyenne County, Nebraska",30145,26983.0,17437,11517,6805,23340
1634,31035,"Clay County, Nebraska",29990,21147.0,16870,10511,5997,23993
1635,31037,"Colfax County, Nebraska",24901,20872.0,15148,10180,6005,18896
1636,31039,"Cuming County, Nebraska",30734,22783.0,16443,10171,6118,24616
1637,31041,"Custer County, Nebraska",32021,21685.0,16171,11116,6025,25996
1638,31043,"Dakota County, Nebraska",26416,19048.0,16125,10635,6494,19922
1639,31045,"Dawes County, Nebraska",25380,18573.0,16353,9357,6031,19349
1640,31047,"Dawson County, Nebraska",31411,19384.0,15973,10849,6685,24726
1641,31049,"Deuel County, Nebraska",27998,23758.0,17891,10434,6573,21425
1642,31051,"Dixon County, Nebraska",31967,20478.0,15350,9074,5312,26655
1643,31053,"Dodge County, Nebraska",29619,22049.0,17757,11638,7070,22549
1644,31055,"Douglas County, Nebraska",36303,28092.0,22879,14644,7809,28494
1645,31057,"Dundy County, Nebraska",27697,24701.0,15786,10894,6061,21636
1646,31059,"Fillmore County, Nebraska",40702,21990.0,17465,11961,6340,34362
1647,31061,"Franklin County, Nebraska",27655,19764.0,15390,10968,5872,21783
1648,31063,"Frontier County, Nebraska",29043,22374.0,16648,9611,6116,22927
1649,31065,"Furnas County, Nebraska",27190,21644.0,17223,9432,5426,21764
1650,31067,"Gage County, Nebraska",29289,21619.0,17190,11099,6389,22900
1651,31069,"Garden County, Nebraska",33689,19740.0,15414,10135,6571,27118
1652,31071,"Garfield County, Nebraska",29119,19235.0,14368,9043,5116,24003
1653,31073,"Gosper County, Nebraska",35290,23132.0,17957,11738,5786,29504
1654,31075,"Grant County, Nebraska",23806,20518.0,14815,10273,5519,18287
1655,31077,"Greeley County, Nebraska",26336,19235.0,13731,8595,4547,21789
1656,31079,"Hall County, Nebraska",29604,22552.0,17386,11526,7158,22446
1657,31081,"Hamilton County, Nebraska",32535,23240.0,17590,11103,6528,26007
1658,31083,"Harlan County, Nebraska",31978,25050.0,15618,9721,5736,26242
1659,31085,"Hayes County, Nebraska",30768,21977.0,14099,13871,5237,25531
1660,31087,"Hitchcock County, Nebraska",29278,20853.0,14804,10689,5608,23670
1661,31089,"Holt County, Nebraska",31089,22498.0,15256,10164,5108,25981
1662,31091,"Hooker County, Nebraska",28859,21197.0,15513,9381,4969,23890
1663,31093,"Howard County, Nebraska",28108,22325.0,15535,9551,5664,22444
1664,31095,"Jefferson County, Nebraska",28748,21976.0,18380,11126,6319,22429
1665,31097,"Johnson County, Nebraska",24145,17606.0,16437,11229,5552,18593
1666,31099,"Kearney County, Nebraska",33784,27227.0,18118,11751,6729,27055
1667,31101,"Keith County, Nebraska",30947,25315.0,17421,10771,6723,24224
1668,31103,"Keya Paha County, Nebraska",32202,20691.0,11860,7907,5972,26230
1669,31105,"Kimball County, Nebraska",26528,22263.0,17525,11105,6544,19984
1670,31107,"Knox County, Nebraska",29210,19894.0,13971,9881,5015,24195
1671,31109,"Lancaster County, Nebraska",33382,25949.0,21265,13803,7645,25737
1672,31111,"Lincoln County, Nebraska",31256,25319.0,18696,12091,7724,23532
1673,31113,"Logan County, Nebraska",21836,22320.0,14937,9186,4416,17420
1674,31115,"Loup County, Nebraska",26975,20004.0,12427,8817,5440,21535
1675,31117,"Mcpherson County, Nebraska",33001,21000.0,13055,10601,6609,26392
1676,31119,"Madison County, Nebraska",28735,22157.0,16804,11054,6940,21795
1677,31121,"Merrick County, Nebraska",27476,21819.0,15958,10194,6018,21458
1678,31123,"Morrill County, Nebraska",25492,21367.0,14725,10102,5051,20441
1679,31125,"Nance County, Nebraska",29841,21457.0,16886,8936,4901,24940
1680,31127,"Nemaha County, Nebraska",28448,22151.0,17004,11343,6423,22025
1681,31129,"Nuckolls County, Nebraska",34248,20299.0,15608,9862,5960,28288
1682,31131,"Otoe County, Nebraska",32165,23773.0,17752,10990,6668,25497
1683,31133,"Pawnee County, Nebraska",24870,21865.0,16687,9316,5009,19861
1684,31135,"Perkins County, Nebraska",33535,23542.0,17830,9933,5979,27556
1685,31137,"Phelps County, Nebraska",31259,23951.0,19044,12837,7192,24067
1686,31139,"Pierce County, Nebraska",31292,21419.0,15980,10430,5635,25657
1687,31141,"Platte County, Nebraska",30822,23358.0,18064,11566,6796,24026
1688,31143,"Polk County, Nebraska",28978,23831.0,17934,11377,6021,22957
1689,31145,"Red Willow County, Nebraska",28395,21246.0,16303,11146,7040,21355
1690,31147,"Richardson County, Nebraska",29074,20516.0,16460,9943,5813,23261
1691,31149,"Rock County, Nebraska",33216,23871.0,14350,9396,5899,27317
1692,31151,"Saline County, Nebraska",25760,20431.0,16287,10732,6821,18939
1693,31153,"Sarpy County, Nebraska",36926,29212.0,21985,13284,6968,29958
1694,31155,"Saunders County, Nebraska",34532,26898.0,18392,11115,6426,28106
1695,31157,"Scotts Bluff County, Nebraska",28770,21212.0,17355,10644,6288,22482
1696,31159,"Seward County, Nebraska",32367,26386.0,18379,11154,6339,26028
1697,31161,"Sheridan County, Nebraska",30173,20066.0,14844,10891,6605,23568
1698,31163,"Sherman County, Nebraska",28344,20900.0,14064,8176,4467,23877
1699,31165,"Sioux County, Nebraska",25398,25824.0,15999,11001,6488,18910
1700,31167,"Stanton County, Nebraska",30747,23018.0,15511,9861,5940,24807
1701,31169,"Thayer County, Nebraska",30568,21648.0,17043,10172,6153,24415
1702,31171,"Thomas County, Nebraska",35694,31499.0,15335,7865,6017,29677
1703,31173,"Thurston County, Nebraska",20674,15686.0,10951,7940,5068,15606
1704,31175,"Valley County, Nebraska",31264,21058.0,14996,9589,5598,25666
1705,31177,"Washington County, Nebraska",36834,27884.0,21055,13132,6955,29879
1706,31179,"Wayne County, Nebraska",27460,19681.0,14644,9128,5917,21543
1707,31181,"Webster County, Nebraska",32092,18906.0,16802,9339,5758,26334
1708,31183,"Wheeler County, Nebraska",31775,20614.0,14355,10329,4811,26964
1709,31185,"York County, Nebraska",34259,25412.0,17670,11434,6961,27298
1710,32001,"Churchill County, Nevada",28659,22997.0,19264,12611,6447,22212
1711,32003,"Clark County, Nevada",31651,27422.0,21785,15109,8259,23392
1712,32005,"Douglas County, Nevada",41921,35239.0,27288,17620,10717,31204
1713,32007,"Elko County, Nevada",34601,26879.0,18482,14050,7263,27338
1714,32009,"Esmeralda County, Nevada",23192,34571.0,18971,12776,7410,15782
1715,32011,"Eureka County, Nevada",30516,30306.0,18629,14474,5813,24703
1716,32013,"Humboldt County, Nevada",33258,25965.0,19539,13544,6876,26382
1717,32015,"Lander County, Nevada",34911,25287.0,16998,13167,7254,27657
1718,32017,"Lincoln County, Nevada",26805,18148.0,17326,9074,5582,21223
1719,32019,"Lyon County, Nevada",29865,21041.0,18543,11704,7061,22804
1720,32021,"Mineral County, Nevada",21746,23226.0,16952,11785,6153,15593
1721,32023,"Nye County, Nevada",25622,22687.0,17962,15454,7169,18453
1722,32027,"Pershing County, Nevada",21765,17519.0,16589,11488,6591,15174
1723,32029,"Storey County, Nevada",39758,31079.0,23642,15623,8167,31591
1724,32031,"Washoe County, Nevada",37689,29687.0,24277,16365,9491,28198
1725,32033,"White Pine County, Nevada",27322,21615.0,18309,12317,7079,20243
1726,32510,"Carson City, Nevada",32819,27568.0,20943,15131,8148,24671
1727,33001,"Belknap County, New Hampshire",37766,28517.0,22758,14439,6553,31213
1728,33003,"Carroll County, New Hampshire",42085,28411.0,21931,14041,6659,35426
1729,33005,"Cheshire County, New Hampshire",34242,27045.0,20685,13887,6577,27665
1730,33007,"Coos County, New Hampshire",28442,22976.0,17218,11963,5746,22696
1731,33009,"Grafton County, New Hampshire",39669,28170.0,22227,13611,6403,33266
1732,33011,"Hillsborough County, New Hampshire",42081,33108.0,25198,17404,7390,34691
1733,33013,"Merrimack County, New Hampshire",38213,30544.0,23208,16057,6920,31293
1734,33015,"Rockingham County, New Hampshire",48675,35889.0,26656,17694,7445,41230
1735,33017,"Strafford County, New Hampshire",36659,28059.0,20479,13999,6309,30350
1736,33019,"Sullivan County, New Hampshire",33207,26322.0,21319,12935,6486,26721
1737,34001,"Atlantic County, New Jersey",34175,27247.0,21034,16016,7194,26981
1738,34003,"Bergen County, New Jersey",52800,42006.0,33638,24080,10188,42612
1739,34005,"Burlington County, New Jersey",44735,34802.0,26339,17707,7671,37064
1740,34007,"Camden County, New Jersey",36559,29478.0,22354,15773,7278,29281
1741,34009,"Cape May County, New Jersey",42987,33571.0,24172,15536,7079,35908
1742,34011,"Cumberland County, New Jersey",28311,21883.0,17376,12560,6032,22279
1743,34013,"Essex County, New Jersey",39695,31535.0,24943,17574,7538,32157
1744,34015,"Gloucester County, New Jersey",40557,31210.0,22708,15207,6939,33618
1745,34017,"Hudson County, New Jersey",42822,31024.0,21154,14480,6476,36346
1746,34019,"Hunterdon County, New Jersey",58795,48489.0,36370,23236,9168,49627
1747,34021,"Mercer County, New Jersey",44532,36016.0,27914,18936,8095,36437
1748,34023,"Middlesex County, New Jersey",40933,33289.0,26535,18714,8357,32576
1749,34025,"Monmouth County, New Jersey",53886,40976.0,31149,20565,8539,45347
1750,34027,"Morris County, New Jersey",58981,47342.0,36964,25177,9909,49072
1751,34029,"Ocean County, New Jersey",37041,29826.0,23054,15598,7009,30032
1752,34031,"Passaic County, New Jersey",33863,26095.0,21370,16048,7214,26649
1753,34033,"Salem County, New Jersey",33575,27296.0,20874,13961,6714,26861
1754,34035,"Somerset County, New Jersey",58021,47067.0,37970,25111,10123,47898
1755,34037,"Sussex County, New Jersey",46124,35982.0,26992,18566,7755,38369
1756,34039,"Union County, New Jersey",42606,34096.0,26992,19660,9031,33575
1757,34041,"Warren County, New Jersey",40626,32985.0,25728,16716,7463,33163
1758,35001,"Bernalillo County, New Mexico",31229,26143.0,20790,13594,7136,24093
1759,35003,"Catron County, New Mexico",21347,20895.0,13951,8537,4695,16652
1760,35005,"Chaves County, New Mexico",23413,18504.0,14990,10550,5828,17585
1761,35007,"Colfax County, New Mexico",24852,21047.0,16418,10076,5515,19337
1762,35009,"Curry County, New Mexico",23897,19925.0,15049,9843,5962,17935
1763,35011,"De Baca County, New Mexico",15996,20769.0,14065,8896,5187,10809
1764,35013,"Dona Ana County, New Mexico",22772,18315.0,13999,9374,5284,17488
1765,35015,"Eddy County, New Mexico",31766,24587.0,15823,10490,6057,25709
1766,35017,"Grant County, New Mexico",25491,21164.0,14597,9381,5703,19788
1767,35019,"Guadalupe County, New Mexico",19418,13710.0,11241,6529,3850,15568
1768,35021,"Harding County, New Mexico",50027,14684.0,16240,9731,5267,44760
1769,35023,"Hidalgo County, New Mexico",22472,17451.0,12431,10092,5242,17230
1770,35025,"Lea County, New Mexico",26551,19637.0,14184,10025,6921,19630
1771,35027,"Lincoln County, New Mexico",27892,24290.0,19338,10701,6388,21504
1772,35028,"Los Alamos County, New Mexico",60729,49474.0,34646,22900,10442,50287
1773,35029,"Luna County, New Mexico",18433,15687.0,11218,8116,4790,13643
1774,35031,"Mckinley County, New Mexico",16378,12932.0,9872,6628,4196,12182
1775,35033,"Mora County, New Mexico",20662,22035.0,12340,7021,3404,17258
1776,35035,"Otero County, New Mexico",24777,19255.0,14345,10053,5379,19398
1777,35037,"Quay County, New Mexico",21594,18234.0,14938,9461,5561,16033
1778,35039,"Rio Arriba County, New Mexico",23819,19913.0,14263,7859,3937,19882
1779,35041,"Roosevelt County, New Mexico",20230,16933.0,14185,9254,5180,15050
1780,35043,"Sandoval County, New Mexico",30273,25979.0,19174,10849,5117,25156
1781,35045,"San Juan County, New Mexico",22840,20725.0,14282,8911,5814,17026
1782,35047,"San Miguel County, New Mexico",22678,18508.0,13268,8149,3904,18774
1783,35049,"Santa Fe County, New Mexico",38288,32188.0,23594,15327,6855,31433
1784,35051,"Sierra County, New Mexico",28014,16667.0,15023,10124,4637,23377
1785,35053,"Socorro County, New Mexico",20015,17801.0,12826,9154,4469,15546
1786,35055,"Taos County, New Mexico",30580,22145.0,16103,9158,4613,25967
1787,35057,"Torrance County, New Mexico",21235,17278.0,14134,8950,4691,16544
1788,35059,"Union County, New Mexico",21083,19228.0,14700,10603,5957,15126
1789,35061,"Valencia County, New Mexico",25106,19955.0,14747,10244,5850,19256
1790,36001,"Albany County, New York",38592,30863.0,23345,16363,7598,30994
1791,36003,"Allegany County, New York",26030,20058.0,14975,9907,5183,20847
1792,36005,"Bronx County, New York",22749,17575.0,13959,10535,5343,17406
1793,36007,"Broome County, New York",29721,24314.0,19168,13626,6871,22850
1794,36009,"Cattaraugus County, New York",26797,20824.0,15959,10595,5612,21185
1795,36011,"Cayuga County, New York",30996,22959.0,18003,11671,5936,25060
1796,36013,"Chautauqua County, New York",27061,21033.0,16840,11287,6187,20874
1797,36015,"Chemung County, New York",29959,23457.0,18264,12069,6253,23706
1798,36017,"Chenango County, New York",28780,22036.0,16427,11830,5717,23063
1799,36019,"Clinton County, New York",29960,22660.0,17946,11444,5343,24617
1800,36021,"Columbia County, New York",40475,31844.0,22265,14044,6395,34080
1801,36023,"Cortland County, New York",28407,22078.0,16622,11228,5625,22782
1802,36025,"Delaware County, New York",28139,22928.0,17357,11180,5692,22447
1803,36027,"Dutchess County, New York",42309,31642.0,23940,17420,7559,34750
1804,36029,"Erie County, New York",35050,26378.0,20357,13560,7094,27956
1805,36031,"Essex County, New York",33906,24390.0,18194,11354,5822,28084
1806,36033,"Franklin County, New York",26886,19807.0,15888,9771,5283,21603
1807,36035,"Fulton County, New York",29984,23147.0,16844,11330,5973,24011
1808,36037,"Genesee County, New York",30846,24323.0,18498,12705,6678,24168
1809,36039,"Greene County, New York",30970,23461.0,18931,12722,6010,24960
1810,36041,"Hamilton County, New York",28758,29965.0,18643,11682,5469,23289
1811,36043,"Herkimer County, New York",29540,21908.0,16141,10543,5654,23886
1812,36045,"Jefferson County, New York",28120,21823.0,16202,11160,5602,22518
1813,36047,"Kings County, New York",36295,23605.0,16775,12388,5753,30542
1814,36049,"Lewis County, New York",27770,20970.0,14971,10455,5356,22414
1815,36051,"Livingston County, New York",30523,22923.0,18062,12585,6205,24318
1816,36053,"Madison County, New York",32443,24311.0,19105,12334,5961,26482
1817,36055,"Monroe County, New York",35339,26999.0,22821,16162,8294,27045
1818,36057,"Montgomery County, New York",27346,22347.0,17005,11640,6022,21324
1819,36059,"Nassau County, New York",53363,41387.0,32151,23352,9974,43389
1820,36061,"New York County, New York",78771,59149.0,42922,27862,10776,67995
1821,36063,"Niagara County, New York",31762,24224.0,19219,12710,6978,24784
1822,36065,"Oneida County, New York",30678,23458.0,18516,12227,6148,24530
1823,36067,"Onondaga County, New York",34600,27037.0,21336,14703,7286,27314
1824,36069,"Ontario County, New York",37044,28950.0,21533,14601,6881,30163
1825,36071,"Orange County, New York",35616,28944.0,21597,15198,6714,28902
1826,36073,"Orleans County, New York",26894,20812.0,16457,11776,6534,20360
1827,36075,"Oswego County, New York",30026,21604.0,16853,11792,5898,24128
1828,36077,"Otsego County, New York",30223,22902.0,16806,11657,5554,24669
1829,36079,"Putnam County, New York",47533,37915.0,30127,20536,8286,39247
1830,36081,"Queens County, New York",33626,25553.0,19222,15348,7549,26077
1831,36083,"Rensselaer County, New York",37011,27457.0,21095,14031,6327,30684
1832,36085,"Richmond County, New York",38096,30843.0,23905,17507,7576,30520
1833,36087,"Rockland County, New York",39923,34304.0,28082,20195,8632,31291
1834,36089,"St. Lawrence County, New York",26676,20143.0,15728,10346,5272,21404
1835,36091,"Saratoga County, New York",45624,32186.0,23945,15644,6884,38740
1836,36093,"Schenectady County, New York",33379,27500.0,21992,15378,7470,25909
1837,36095,"Schoharie County, New York",32352,25105.0,17778,11333,5353,26999
1838,36097,"Schuyler County, New York",28844,22123.0,17039,10825,5592,23252
1839,36099,"Seneca County, New York",28703,21818.0,17630,12408,6395,22308
1840,36101,"Steuben County, New York",30844,23279.0,18197,11933,6247,24597
1841,36103,"Suffolk County, New York",46466,35755.0,26577,18481,7581,38885
1842,36105,"Sullivan County, New York",32346,23422.0,18892,12567,5866,26480
1843,36107,"Tioga County, New York",32298,24596.0,18673,13064,6605,25693
1844,36109,"Tompkins County, New York",34194,25737.0,19659,13171,6264,27930
1845,36111,"Ulster County, New York",35816,28954.0,20846,14921,6634,29182
1846,36113,"Warren County, New York",38740,27744.0,20727,14378,6186,32554
1847,36115,"Washington County, New York",29014,22347.0,17958,12221,5442,23572
1848,36117,"Wayne County, New York",32513,24092.0,19258,13313,6666,25847
1849,36119,"Westchester County, New York",57953,47814.0,36726,25584,10603,47350
1850,36121,"Wyoming County, New York",29734,20605.0,17248,10552,5746,23988
1851,36123,"Yates County, New York",28001,23255.0,16781,11065,5976,22025
1852,37001,"Alamance County, North Carolina",27944,22819.0,19391,13290,6534,21410
1853,37003,"Alexander County, North Carolina",27446,20716.0,18507,11624,5731,21715
1854,37005,"Alleghany County, North Carolina",26026,18919.0,17691,10237,4934,21092
1855,37007,"Anson County, North Carolina",22483,16856.0,14853,9402,4826,17657
1856,37009,"Ashe County, North Carolina",25282,20350.0,16429,9545,4652,20630
1857,37011,"Avery County, North Carolina",24036,23465.0,15176,9729,4575,19461
1858,37013,"Beaufort County, North Carolina",28077,22728.0,16722,10722,5193,22884
1859,37015,"Bertie County, North Carolina",22245,17614.0,14096,8392,4376,17869
1860,37017,"Bladen County, North Carolina",24752,17890.0,14735,9497,4514,20238
1861,37019,"Brunswick County, North Carolina",34528,26315.0,19857,11688,5321,29207
1862,37021,"Buncombe County, North Carolina",33835,25665.0,20384,13211,6360,27475
1863,37023,"Burke County, North Carolina",25053,19220.0,17397,11604,5881,19172
1864,37025,"Cabarrus County, North Carolina",33548,26165.0,21121,13552,6457,27091
1865,37027,"Caldwell County, North Carolina",24666,19686.0,17353,11522,5653,19013
1866,37029,"Camden County, North Carolina",28596,25544.0,18681,10465,5539,23057
1867,37031,"Carteret County, North Carolina",34038,26791.0,21260,13227,6146,27892
1868,37033,"Caswell County, North Carolina",24121,17814.0,16470,9817,4918,19203
1869,37035,"Catawba County, North Carolina",29364,22969.0,20358,13764,6672,22692
1870,37037,"Chatham County, North Carolina",45036,29991.0,23355,13321,6203,38833
1871,37039,"Cherokee County, North Carolina",24024,20747.0,15814,9258,4445,19579
1872,37041,"Chowan County, North Carolina",27254,20900.0,15027,10606,5202,22052
1873,37043,"Clay County, North Carolina",32744,20474.0,18221,9456,4737,28007
1874,37045,"Cleveland County, North Carolina",23061,19284.0,17395,11875,5904,17157
1875,37047,"Columbus County, North Carolina",22426,18784.0,14415,9134,4751,17675
1876,37049,"Craven County, North Carolina",29908,24591.0,18423,11619,5650,24258
1877,37051,"Cumberland County, North Carolina",25648,22285.0,17376,11100,5425,20223
1878,37053,"Currituck County, North Carolina",34726,26083.0,19908,12630,5266,29460
1879,37055,"Dare County, North Carolina",36532,30327.0,23614,15107,7022,29510
1880,37057,"Davidson County, North Carolina",26616,22268.0,18703,12597,6227,20389
1881,37059,"Davie County, North Carolina",32638,26139.0,21359,14648,6343,26295
1882,37061,"Duplin County, North Carolina",21145,16693.0,14499,9406,4653,16492
1883,37063,"Durham County, North Carolina",36759,27503.0,23156,15030,6828,29931
1884,37065,"Edgecombe County, North Carolina",21595,16747.0,14435,9530,5068,16527
1885,37067,"Forsyth County, North Carolina",31201,26213.0,23023,16151,7454,23747
1886,37069,"Franklin County, North Carolina",27588,21331.0,17562,10959,4836,22752
1887,37071,"Gaston County, North Carolina",28526,22305.0,19225,12447,6309,22217
1888,37073,"Gates County, North Carolina",26053,19893.0,15963,11561,5143,20910
1889,37075,"Graham County, North Carolina",23034,17825.0,14237,8877,4615,18419
1890,37077,"Granville County, North Carolina",27723,21733.0,17118,10939,4989,22734
1891,37079,"Greene County, North Carolina",19415,17362.0,15452,9567,4976,14439
1892,37081,"Guilford County, North Carolina",31798,26267.0,23340,15373,7426,24372
1893,37083,"Halifax County, North Carolina",21902,17223.0,13810,8980,4515,17387
1894,37085,"Harnett County, North Carolina",24693,19274.0,16775,10053,5063,19630
1895,37087,"Haywood County, North Carolina",30336,24233.0,18554,11731,5735,24601
1896,37089,"Henderson County, North Carolina",32306,26061.0,21110,13702,6412,25894
1897,37091,"Hertford County, North Carolina",21715,17002.0,15641,9016,4787,16928
1898,37093,"Hoke County, North Carolina",23066,17630.0,13635,8688,4484,18582
1899,37095,"Hyde County, North Carolina",17942,14992.0,13164,9434,4295,13647
1900,37097,"Iredell County, North Carolina",35261,25610.0,21148,13000,6125,29136
1901,37099,"Jackson County, North Carolina",25738,20228.0,17582,10326,4987,20751
1902,37101,"Johnston County, North Carolina",29327,22437.0,18788,11839,5331,23996
1903,37103,"Jones County, North Carolina",22917,20066.0,15916,8832,4461,18456
1904,37105,"Lee County, North Carolina",25502,21061.0,19147,12042,6320,19182
1905,37107,"Lenoir County, North Carolina",24894,19017.0,16744,10647,5421,19473
1906,37109,"Lincoln County, North Carolina",33197,23560.0,18877,12440,6058,27139
1907,37111,"Mcdowell County, North Carolina",25432,18798.0,16109,10516,5274,20158
1908,37113,"Macon County, North Carolina",29549,26156.0,18642,11017,5671,23878
1909,37115,"Madison County, North Carolina",27184,18792.0,16076,9149,4670,22514
1910,37117,"Martin County, North Carolina",24108,18728.0,15102,9486,4781,19327
1911,37119,"Mecklenburg County, North Carolina",40627,31848.0,27352,16910,7872,32755
1912,37121,"Mitchell County, North Carolina",26975,18804.0,15933,10219,5018,21957
1913,37123,"Montgomery County, North Carolina",23863,18618.0,16504,10695,5128,18735
1914,37125,"Moore County, North Carolina",36184,25786.0,23377,14934,6660,29524
1915,37127,"Nash County, North Carolina",27286,23909.0,18863,12684,6043,21243
1916,37129,"New Hanover County, North Carolina",36324,29363.0,23123,13863,6747,29577
1917,37131,"Northampton County, North Carolina",23946,17128.0,15413,8244,4591,19355
1918,37133,"Onslow County, North Carolina",24817,21048.0,14853,10713,5114,19703
1919,37135,"Orange County, North Carolina",42872,32912.0,24873,15776,6927,35945
1920,37137,"Pamlico County, North Carolina",28257,23320.0,18005,10665,5076,23181
1921,37139,"Pasquotank County, North Carolina",26898,21736.0,14815,10718,5276,21622
1922,37141,"Pender County, North Carolina",30666,22872.0,17882,11460,4996,25670
1923,37143,"Perquimans County, North Carolina",28160,22085.0,15728,9821,4523,23637
1924,37145,"Person County, North Carolina",31605,21848.0,18709,11158,5424,26181
1925,37147,"Pitt County, North Carolina",27599,21935.0,18243,11642,5577,22022
1926,37149,"Polk County, North Carolina",32327,24008.0,19804,14213,6472,25855
1927,37151,"Randolph County, North Carolina",25246,21297.0,18236,12102,6274,18972
1928,37153,"Richmond County, North Carolina",22068,17692.0,14485,9841,5492,16576
1929,37155,"Robeson County, North Carolina",19388,15321.0,13224,8878,4502,14886
1930,37157,"Rockingham County, North Carolina",25268,20801.0,17120,11546,6045,19223
1931,37159,"Rowan County, North Carolina",26789,21525.0,18071,12018,6315,20474
1932,37161,"Rutherford County, North Carolina",24308,18961.0,16270,11287,5516,18792
1933,37163,"Sampson County, North Carolina",23502,19086.0,14976,9480,4737,18765
1934,37165,"Scotland County, North Carolina",20975,16297.0,15693,9768,5435,15540
1935,37167,"Stanly County, North Carolina",26956,21139.0,17825,11265,5966,20990
1936,37169,"Stokes County, North Carolina",27979,20852.0,18130,12181,5610,22369
1937,37171,"Surry County, North Carolina",26074,20541.0,17722,11342,5691,20383
1938,37173,"Swain County, North Carolina",24234,19297.0,14647,8922,4123,20111
1939,37175,"Transylvania County, North Carolina",30577,23939.0,20767,12737,6292,24285
1940,37177,"Tyrrell County, North Carolina",21129,15812.0,13326,7884,4139,16990
1941,37179,"Union County, North Carolina",37667,28596.0,21978,13135,6341,31326
1942,37181,"Vance County, North Carolina",23911,17622.0,15897,10457,4988,18923
1943,37183,"Wake County, North Carolina",42721,32592.0,27004,17195,7708,35013
1944,37185,"Warren County, North Carolina",25340,17838.0,14716,8502,4375,20965
1945,37187,"Washington County, North Carolina",23249,16982.0,14994,9827,5199,18050
1946,37189,"Watauga County, North Carolina",27962,20961.0,17258,10628,5097,22865
1947,37191,"Wayne County, North Carolina",26362,20446.0,17010,10843,5320,21042
1948,37193,"Wilkes County, North Carolina",25634,19406.0,17516,10816,5767,19867
1949,37195,"Wilson County, North Carolina",24656,20691.0,17102,11641,5754,18902
1950,37197,"Yadkin County, North Carolina",26907,20379.0,18576,11843,5645,21262
1951,37199,"Yancey County, North Carolina",25767,18576.0,16335,9462,4530,21237
1952,38001,"Adams County, North Dakota",31022,20118.0,18425,10382,5864,25158
1953,38003,"Barnes County, North Dakota",34334,26152.0,16566,10102,6220,28114
1954,38005,"Benson County, North Dakota",21629,14545.0,11509,6983,4958,16671
1955,38007,"Billings County, North Dakota",38113,28666.0,16186,9172,8094,30019
1956,38009,"Bottineau County, North Dakota",37339,26277.0,16227,10557,5765,31574
1957,38011,"Bowman County, North Dakota",36739,27354.0,17662,10060,6195,30544
1958,38013,"Burke County, North Dakota",43862,32347.0,14026,9176,5351,38511
1959,38015,"Burleigh County, North Dakota",39509,28784.0,20436,13018,7767,31742
1960,38017,"Cass County, North Dakota",37784,28184.0,20889,13240,7686,30098
1961,38019,"Cavalier County, North Dakota",43386,26468.0,15817,10653,6107,37279
1962,38021,"Dickey County, North Dakota",34263,21824.0,15846,9747,5243,29020
1963,38023,"Divide County, North Dakota",39464,28462.0,16225,10603,6235,33229
1964,38025,"Dunn County, North Dakota",45782,24832.0,14624,8689,5650,40132
1965,38027,"Eddy County, North Dakota",34614,20302.0,15941,9398,5830,28784
1966,38029,"Emmons County, North Dakota",32294,21358.0,14604,8421,4692,27602
1967,38031,"Foster County, North Dakota",38329,27945.0,17928,9393,6357,31972
1968,38033,"Golden Valley County, North Dakota",37890,21899.0,14173,9290,6239,31651
1969,38035,"Grand Forks County, North Dakota",32251,24276.0,17868,11414,6519,25732
1970,38037,"Grant County, North Dakota",34059,25840.0,14616,8511,4262,29797
1971,38039,"Griggs County, North Dakota",38386,24122.0,16131,8816,5782,32604
1972,38041,"Hettinger County, North Dakota",35683,24928.0,15555,9203,5104,30579
1973,38043,"Kidder County, North Dakota",30567,23502.0,14270,8700,4543,26024
1974,38045,"La Moure County, North Dakota",35278,27056.0,17059,9271,5218,30060
1975,38047,"Logan County, North Dakota",32947,21654.0,16947,10304,4639,28308
1976,38049,"Mchenry County, North Dakota",35125,22911.0,15140,8871,4949,30176
1977,38051,"Mcintosh County, North Dakota",33281,22608.0,15018,9133,5145,28136
1978,38053,"Mckenzie County, North Dakota",36414,27605.0,14732,9832,6142,30272
1979,38055,"Mclean County, North Dakota",37651,27029.0,16220,9733,6068,31583
1980,38057,"Mercer County, North Dakota",39745,30616.0,18256,12195,7071,32674
1981,38059,"Morton County, North Dakota",38890,25303.0,17202,10534,6249,32641
1982,38061,"Mountrail County, North Dakota",34954,25762.0,13422,9265,5476,29478
1983,38063,"Nelson County, North Dakota",34189,22838.0,16320,9590,5529,28660
1984,38065,"Oliver County, North Dakota",32784,29348.0,16271,9749,5984,26800
1985,38067,"Pembina County, North Dakota",35096,27019.0,18692,11308,6104,28992
1986,38069,"Pierce County, North Dakota",31582,18575.0,14055,8993,5279,26303
1987,38071,"Ramsey County, North Dakota",33797,24130.0,18060,11125,6347,27450
1988,38073,"Ransom County, North Dakota",34842,21995.0,18219,11297,5636,29206
1989,38075,"Renville County, North Dakota",34411,26856.0,16478,10759,5730,28681
1990,38077,"Richland County, North Dakota",32008,24342.0,16339,10562,6267,25741
1991,38079,"Rolette County, North Dakota",20424,13632.0,10873,6773,4147,16277
1992,38081,"Sargent County, North Dakota",38042,26553.0,18689,10867,5761,32281
1993,38083,"Sheridan County, North Dakota",35335,24286.0,13283,8152,4936,30399
1994,38085,"Sioux County, North Dakota",17460,13542.0,7731,5185,3642,13818
1995,38087,"Slope County, North Dakota",36040,24824.0,14513,8234,4936,31104
1996,38089,"Stark County, North Dakota",37780,25282.0,15929,10136,6442,31338
1997,38091,"Steele County, North Dakota",38907,27728.0,17601,11586,6919,31988
1998,38093,"Stutsman County, North Dakota",31461,23307.0,17706,11369,6494,24967
1999,38095,"Towner County, North Dakota",36427,24203.0,17605,9481,6212,30215
2000,38097,"Traill County, North Dakota",34065,23340.0,18014,10509,6508,27557
2001,38099,"Walsh County, North Dakota",34441,23829.0,16496,10766,5211,29230
2002,38101,"Ward County, North Dakota",35891,25326.0,16926,10708,6389,29502
2003,38103,"Wells County, North Dakota",36563,23531.0,17932,9957,5520,31043
2004,38105,"Williams County, North Dakota",43364,29153.0,16763,11165,7565,35799
2005,39001,"Adams County, Ohio",23294,17693.0,14515,8407,4598,18696
2006,39003,"Allen County, Ohio",27231,21713.0,17511,11830,6902,20329
2007,39005,"Ashland County, Ohio",27403,20558.0,17308,11623,6516,20887
2008,39007,"Ashtabula County, Ohio",25556,19898.0,16814,10672,6523,19033
2009,39009,"Athens County, Ohio",22287,16642.0,14171,9170,5091,17196
2010,39011,"Auglaize County, Ohio",32194,25290.0,19593,12398,6620,25574
2011,39013,"Belmont County, Ohio",27393,20266.0,16221,10329,6647,20746
2012,39015,"Brown County, Ohio",28320,20167.0,17100,10498,5641,22679
2013,39017,"Butler County, Ohio",33018,25892.0,22076,13947,7344,25674
2014,39019,"Carroll County, Ohio",29915,21575.0,16701,10693,6018,23897
2015,39021,"Champaign County, Ohio",28403,23438.0,19542,12539,6500,21903
2016,39023,"Clark County, Ohio",27274,22110.0,19501,12348,6804,20470
2017,39025,"Clermont County, Ohio",35472,27900.0,22370,13338,7001,28471
2018,39027,"Clinton County, Ohio",28107,22163.0,18462,11736,6280,21827
2019,39029,"Columbiana County, Ohio",26769,19635.0,16655,10567,6532,20237
2020,39031,"Coshocton County, Ohio",23863,19635.0,16364,10685,6534,17329
2021,39033,"Crawford County, Ohio",26286,20590.0,17466,11401,6579,19707
2022,39035,"Cuyahoga County, Ohio",34398,26263.0,22272,14912,8099,26299
2023,39037,"Darke County, Ohio",28639,21483.0,18670,11693,6303,22336
2024,39039,"Defiance County, Ohio",31051,22139.0,19667,12545,7157,23894
2025,39041,"Delaware County, Ohio",48312,40682.0,31600,17437,7366,40946
2026,39043,"Erie County, Ohio",34352,25290.0,21530,13833,7523,26829
2027,39045,"Fairfield County, Ohio",33283,26130.0,21671,13609,7067,26216
2028,39047,"Fayette County, Ohio",25993,20525.0,18063,10300,5766,20227
2029,39049,"Franklin County, Ohio",34790,26909.0,23059,14907,7591,27199
2030,39051,"Fulton County, Ohio",30252,22804.0,18999,12467,6873,23379
2031,39053,"Gallia County, Ohio",25567,20199.0,15183,9711,5954,19613
2032,39055,"Geauga County, Ohio",41874,32735.0,27944,17587,8773,33101
2033,39057,"Greene County, Ohio",36386,28328.0,23057,14384,7501,28885
2034,39059,"Guernsey County, Ohio",25878,19187.0,15542,9929,5986,19892
2035,39061,"Hamilton County, Ohio",37028,28799.0,24053,15354,7871,29157
2036,39063,"Hancock County, Ohio",32829,25158.0,20991,14239,7411,25418
2037,39065,"Hardin County, Ohio",23498,19100.0,16200,10957,6159,17339
2038,39067,"Harrison County, Ohio",25751,19318.0,16479,9146,5998,19753
2039,39069,"Henry County, Ohio",30188,22638.0,18667,12115,6959,23229
2040,39071,"Highland County, Ohio",24058,18966.0,16521,9848,5533,18525
2041,39073,"Hocking County, Ohio",26733,19048.0,16095,10265,5665,21068
2042,39075,"Holmes County, Ohio",24751,17009.0,14197,9191,4961,19790
2043,39077,"Huron County, Ohio",26766,21743.0,18133,11552,6781,19985
2044,39079,"Jackson County, Ohio",25004,18775.0,14789,9228,5309,19695
2045,39081,"Jefferson County, Ohio",26602,20470.0,16476,11001,7191,19411
2046,39083,"Knox County, Ohio",27599,21204.0,17695,10688,5957,21642
2047,39085,"Lake County, Ohio",35007,28221.0,23160,15465,8263,26744
2048,39087,"Lawrence County, Ohio",24733,19452.0,14678,9336,5776,18957
2049,39089,"Licking County, Ohio",33514,25534.0,20581,12864,7010,26504
2050,39091,"Logan County, Ohio",30266,22974.0,18984,11741,6209,24057
2051,39093,"Lorain County, Ohio",31627,25002.0,21054,12733,7209,24418
2052,39095,"Lucas County, Ohio",29496,23981.0,20518,13778,7588,21908
2053,39097,"Madison County, Ohio",29885,23980.0,18721,12053,6318,23567
2054,39099,"Mahoning County, Ohio",28693,22824.0,18818,11668,6928,21765
2055,39101,"Marion County, Ohio",25899,19849.0,18255,11547,6672,19227
2056,39103,"Medina County, Ohio",38446,29986.0,24251,14852,7862,30584
2057,39105,"Meigs County, Ohio",24342,18003.0,13848,8644,5359,18983
2058,39107,"Mercer County, Ohio",30975,22348.0,18531,11673,6611,24364
2059,39109,"Miami County, Ohio",31170,25006.0,21669,13896,7102,24068
2060,39111,"Monroe County, Ohio",28521,18738.0,15096,9101,5969,22552
2061,39113,"Montgomery County, Ohio",31146,24828.0,21743,14495,7643,23503
2062,39115,"Morgan County, Ohio",23053,18777.0,13967,9373,5413,17640
2063,39117,"Morrow County, Ohio",30098,20795.0,17830,10581,5974,24124
2064,39119,"Muskingum County, Ohio",26376,20561.0,17533,10844,6134,20242
2065,39121,"Noble County, Ohio",25776,20029.0,14100,9028,5721,20055
2066,39123,"Ottawa County, Ohio",38553,27809.0,21973,14144,7329,31224
2067,39125,"Paulding County, Ohio",28867,20919.0,18062,11254,6519,22348
2068,39127,"Perry County, Ohio",24668,18916.0,15674,9247,5436,19232
2069,39129,"Pickaway County, Ohio",28017,21432.0,17478,11490,6267,21750
2070,39131,"Pike County, Ohio",26006,17494.0,16093,8958,5015,20991
2071,39133,"Portage County, Ohio",31658,25097.0,20428,12509,6894,24764
2072,39135,"Preble County, Ohio",29769,23290.0,18444,11466,6545,23224
2073,39137,"Putnam County, Ohio",32507,24023.0,18680,11943,6385,26122
2074,39139,"Richland County, Ohio",25570,21459.0,18582,12514,6803,18767
2075,39141,"Ross County, Ohio",25576,20595.0,17569,10758,6251,19325
2076,39143,"Sandusky County, Ohio",28624,22286.0,19239,12230,6968,21656
2077,39145,"Scioto County, Ohio",23512,17778.0,15408,9253,5442,18070
2078,39147,"Seneca County, Ohio",26810,20976.0,17027,11226,6379,20431
2079,39149,"Shelby County, Ohio",30211,21948.0,20255,13150,6532,23679
2080,39151,"Stark County, Ohio",30168,24015.0,20417,13003,7288,22880
2081,39153,"Summit County, Ohio",34684,26676.0,22842,14409,7666,27018
2082,39155,"Trumbull County, Ohio",27255,21854.0,19188,12899,7581,19674
2083,39157,"Tuscarawas County, Ohio",27208,20536.0,17276,11141,6436,20772
2084,39159,"Union County, Ohio",40278,27389.0,20577,13644,6733,33545
2085,39161,"Van Wert County, Ohio",28092,20772.0,18293,11913,6947,21145
2086,39163,"Vinton County, Ohio",22984,16736.0,13731,8826,4804,18180
2087,39165,"Warren County, Ohio",43005,31935.0,25517,14615,7159,35846
2088,39167,"Washington County, Ohio",30184,22786.0,18082,11438,6402,23782
2089,39169,"Wayne County, Ohio",28907,22645.0,18330,12237,6768,22139
2090,39171,"Williams County, Ohio",27395,21381.0,18441,12473,6839,20556
2091,39173,"Wood County, Ohio",33461,26671.0,21284,13853,7235,26226
2092,39175,"Wyandot County, Ohio",29297,22553.0,17170,11279,6295,23002
2093,40001,"Adair County, Oklahoma",17729,13732.0,11185,7378,3908,13821
2094,40003,"Alfalfa County, Oklahoma",24829,21029.0,14704,9999,7175,17654
2095,40005,"Atoka County, Oklahoma",22575,15772.0,12919,8308,4356,18219
2096,40007,"Beaver County, Oklahoma",25313,23525.0,17905,11910,7259,18054
2097,40009,"Beckham County, Oklahoma",23299,21144.0,14488,10400,6608,16691
2098,40011,"Blaine County, Oklahoma",30700,19445.0,13546,9787,6690,24010
2099,40013,"Bryan County, Oklahoma",25089,19103.0,14217,9082,5067,20022
2100,40015,"Caddo County, Oklahoma",22868,16787.0,13298,8735,5570,17298
2101,40017,"Canadian County, Oklahoma",30970,26970.0,19691,13077,7581,23389
2102,40019,"Carter County, Oklahoma",27211,20192.0,15511,11266,6472,20739
2103,40021,"Cherokee County, Oklahoma",22617,16084.0,13436,9446,4794,17823
2104,40023,"Choctaw County, Oklahoma",23194,17231.0,12296,7548,4696,18498
2105,40025,"Cimarron County, Oklahoma",30283,18358.0,15744,9929,6138,24145
2106,40027,"Cleveland County, Oklahoma",32489,25831.0,20114,13182,7404,25085
2107,40029,"Coal County, Oklahoma",22611,17338.0,12013,7695,4495,18116
2108,40031,"Comanche County, Oklahoma",27800,20778.0,15728,10602,5665,22135
2109,40033,"Cotton County, Oklahoma",25784,20948.0,14626,9147,5216,20568
2110,40035,"Craig County, Oklahoma",22239,18784.0,16539,9886,5530,16709
2111,40037,"Creek County, Oklahoma",26876,21891.0,16191,10608,6225,20651
2112,40039,"Custer County, Oklahoma",28102,22003.0,15584,10461,6914,21188
2113,40041,"Delaware County, Oklahoma",34798,20142.0,15424,9572,4760,30038
2114,40043,"Dewey County, Oklahoma",28634,21055.0,15806,9726,6718,21916
2115,40045,"Ellis County, Oklahoma",28277,23767.0,16472,10082,6817,21460
2116,40047,"Garfield County, Oklahoma",28755,22812.0,17457,11564,7744,21011
2117,40049,"Garvin County, Oklahoma",24886,20176.0,14856,9548,5891,18995
2118,40051,"Grady County, Oklahoma",31075,21687.0,15846,10420,6267,24808
2119,40053,"Grant County, Oklahoma",29485,22204.0,15709,11255,7092,22393
2120,40055,"Greer County, Oklahoma",20956,13241.0,14053,9089,5568,15388
2121,40057,"Harmon County, Oklahoma",28137,17677.0,13464,7817,5463,22674
2122,40059,"Harper County, Oklahoma",22148,23693.0,18011,11752,7646,14502
2123,40061,"Haskell County, Oklahoma",23316,18735.0,13775,8320,4929,18387
2124,40063,"Hughes County, Oklahoma",20839,18083.0,12687,8849,4671,16168
2125,40065,"Jackson County, Oklahoma",26511,21249.0,15454,10224,5431,21080
2126,40067,"Jefferson County, Oklahoma",25202,17491.0,12899,8430,5447,19755
2127,40069,"Johnston County, Oklahoma",21918,18451.0,13747,7821,4227,17691
2128,40071,"Kay County, Oklahoma",26705,21167.0,16643,12394,7333,19372
2129,40073,"Kingfisher County, Oklahoma",33651,23481.0,18167,11141,7113,26538
2130,40075,"Kiowa County, Oklahoma",21855,18921.0,14231,9213,5466,16389
2131,40077,"Latimer County, Oklahoma",25534,20353.0,12842,9427,4492,21042
2132,40079,"Le Flore County, Oklahoma",21324,17357.0,13737,8752,4830,16494
2133,40081,"Lincoln County, Oklahoma",26293,20774.0,14890,9952,5616,20677
2134,40083,"Logan County, Oklahoma",35139,25090.0,17872,10946,6125,29014
2135,40085,"Love County, Oklahoma",23266,20817.0,16648,9960,5980,17286
2136,40087,"Mcclain County, Oklahoma",33810,23556.0,18158,11114,6153,27657
2137,40089,"Mccurtain County, Oklahoma",20641,17456.0,13693,8291,4532,16109
2138,40091,"Mcintosh County, Oklahoma",23467,16095.0,16410,9403,4832,18635
2139,40093,"Major County, Oklahoma",28079,24897.0,17272,10745,7120,20959
2140,40095,"Marshall County, Oklahoma",25375,18794.0,14982,9889,5673,19702
2141,40097,"Mayes County, Oklahoma",25937,19975.0,15350,10049,5576,20361
2142,40099,"Murray County, Oklahoma",27843,20634.0,16084,9439,5683,22160
2143,40101,"Muskogee County, Oklahoma",23314,19161.0,14828,9756,5872,17442
2144,40103,"Noble County, Oklahoma",29185,20032.0,17022,10969,6476,22709
2145,40105,"Nowata County, Oklahoma",24532,20752.0,14244,9339,6130,18402
2146,40107,"Okfuskee County, Oklahoma",19724,15046.0,12746,8471,4468,15256
2147,40109,"Oklahoma County, Oklahoma",32165,25723.0,19551,13794,7987,24178
2148,40111,"Okmulgee County, Oklahoma",24305,19071.0,14065,8799,5291,19014
2149,40113,"Osage County, Oklahoma",26852,21446.0,17014,11123,6778,20074
2150,40115,"Ottawa County, Oklahoma",21394,17638.0,14478,9057,5554,15840
2151,40117,"Pawnee County, Oklahoma",25174,19520.0,15261,10416,6522,18652
2152,40119,"Payne County, Oklahoma",24675,19540.0,15983,10907,6061,18614
2153,40121,"Pittsburg County, Oklahoma",25685,20714.0,15494,9832,5351,20334
2154,40123,"Pontotoc County, Oklahoma",27038,21136.0,14664,10005,5825,21213
2155,40125,"Pottawatomie County, Oklahoma",25019,19437.0,15972,10391,6008,19011
2156,40127,"Pushmataha County, Oklahoma",22812,15460.0,12864,7426,4490,18322
2157,40129,"Roger Mills County, Oklahoma",35144,28427.0,16821,9886,6736,28408
2158,40131,"Rogers County, Oklahoma",33030,25358.0,19073,12235,6953,26077
2159,40133,"Seminole County, Oklahoma",20735,17032.0,13956,9044,5503,15232
2160,40135,"Sequoyah County, Oklahoma",21102,18049.0,13405,9074,4727,16375
2161,40137,"Stephens County, Oklahoma",26670,22790.0,16357,10839,6840,19830
2162,40139,"Texas County, Oklahoma",21844,21356.0,15692,11096,7027,14817
2163,40141,"Tillman County, Oklahoma",20984,15894.0,14270,8597,5934,15050
2164,40143,"Tulsa County, Oklahoma",36303,26769.0,21115,14742,8444,27859
2165,40145,"Wagoner County, Oklahoma",30727,24049.0,18272,11839,6484,24243
2166,40147,"Washington County, Oklahoma",31113,26663.0,20250,15086,8921,22192
2167,40149,"Washita County, Oklahoma",28518,21511.0,15528,9642,6776,21742
2168,40151,"Woods County, Oklahoma",25937,24292.0,17487,12261,7441,18496
2169,40153,"Woodward County, Oklahoma",28080,24635.0,16734,11000,7601,20479
2170,41001,"Baker County, Oregon",29615,21683.0,15612,10802,6196,23419
2171,41003,"Benton County, Oregon",35305,26177.0,21868,12994,7162,28143
2172,41005,"Clackamas County, Oregon",42638,31785.0,25973,16360,8599,34039
2173,41007,"Clatsop County, Oregon",31631,25347.0,19515,12568,7555,24076
2174,41009,"Columbia County, Oregon",32438,24613.0,20078,12798,7281,25157
2175,41011,"Coos County, Oregon",30720,21981.0,17547,11088,6930,23790
2176,41013,"Crook County, Oregon",29923,22275.0,16899,11017,6961,22962
2177,41015,"Curry County, Oregon",32125,23842.0,18138,12475,7188,24937
2178,41017,"Deschutes County, Oregon",37615,27920.0,21767,13401,7290,30325
2179,41019,"Douglas County, Oregon",27484,21342.0,16581,10809,6680,20804
2180,41021,"Gilliam County, Oregon",26911,25559.0,17659,12137,7002,19909
2181,41023,"Grant County, Oregon",29449,22041.0,16794,11310,6378,23071
2182,41025,"Harney County, Oregon",26279,20849.0,16159,10990,6922,19357
2183,41027,"Hood River County, Oregon",35904,23930.0,17877,11421,7521,28383
2184,41029,"Jackson County, Oregon",32044,24410.0,19498,12492,6944,25100
2185,41031,"Jefferson County, Oregon",26177,20009.0,15675,9863,6091,20086
2186,41033,"Josephine County, Oregon",27026,21539.0,17234,10809,5875,21151
2187,41035,"Klamath County, Oregon",26508,22081.0,16719,11138,6561,19947
2188,41037,"Lake County, Oregon",26299,22586.0,16136,11231,6287,20012
2189,41039,"Lane County, Oregon",30911,23869.0,19681,12570,7302,23609
2190,41041,"Lincoln County, Oregon",30336,24354.0,18692,12058,7575,22761
2191,41043,"Linn County, Oregon",27820,22165.0,17633,11443,6641,21179
2192,41045,"Malheur County, Oregon",19893,16335.0,13895,9949,5478,14415
2193,41047,"Marion County, Oregon",28856,21915.0,18408,12228,7080,21776
2194,41049,"Morrow County, Oregon",24655,20201.0,15802,10412,7148,17507
2195,41051,"Multnomah County, Oregon",41612,28883.0,22606,14462,8129,33483
2196,41053,"Polk County, Oregon",31957,24345.0,19282,12405,6994,24963
2197,41055,"Sherman County, Oregon",34548,21688.0,17448,13242,6232,28316
2198,41057,"Tillamook County, Oregon",30044,22824.0,19052,11550,7016,23028
2199,41059,"Umatilla County, Oregon",25452,20035.0,16410,11178,6651,18801
2200,41061,"Union County, Oregon",27748,22947.0,16907,10698,6416,21332
2201,41063,"Wallowa County, Oregon",34564,23023.0,17276,10811,6277,28287
2202,41065,"Wasco County, Oregon",31088,21922.0,17195,12542,7368,23720
2203,41067,"Washington County, Oregon",41015,30522.0,24969,16351,9190,31825
2204,41069,"Wheeler County, Oregon",23628,20598.0,15884,9299,5489,18139
2205,41071,"Yamhill County, Oregon",32768,24017.0,18951,12990,6889,25879
2206,42001,"Adams County, Pennsylvania",32312,25606.0,18577,13018,6323,25989
2207,42003,"Allegheny County, Pennsylvania",39541,29549.0,22491,15115,7986,31555
2208,42005,"Armstrong County, Pennsylvania",28824,21828.0,15709,10565,6286,22538
2209,42007,"Beaver County, Pennsylvania",33025,24168.0,18402,11683,7460,25565
2210,42009,"Bedford County, Pennsylvania",26950,20545.0,16316,9954,5403,21547
2211,42011,"Berks County, Pennsylvania",32781,25518.0,21232,14604,7350,25431
2212,42013,"Blair County, Pennsylvania",29336,22880.0,16743,11233,6052,23284
2213,42015,"Bradford County, Pennsylvania",28154,20979.0,17148,10810,5579,22575
2214,42017,"Bucks County, Pennsylvania",47266,35687.0,27430,18292,8048,39218
2215,42019,"Butler County, Pennsylvania",39906,28446.0,20794,12747,6847,33059
2216,42021,"Cambria County, Pennsylvania",27173,21278.0,16058,10460,6324,20849
2217,42023,"Cameron County, Pennsylvania",24379,21375.0,15968,10190,6035,18344
2218,42025,"Carbon County, Pennsylvania",30552,22956.0,17064,11729,6353,24199
2219,42027,"Centre County, Pennsylvania",32238,23744.0,18020,11854,5909,26329
2220,42029,"Chester County, Pennsylvania",52711,41251.0,31627,20601,8763,43948
2221,42031,"Clarion County, Pennsylvania",26595,20259.0,15243,9698,6029,20566
2222,42033,"Clearfield County, Pennsylvania",25043,,16010,10430,6027,19016
2223,42035,"Clinton County, Pennsylvania",26656,19261.0,15750,10287,5830,20826
2224,42037,"Columbia County, Pennsylvania",28051,22403.0,16973,10959,5722,22329
2225,42039,"Crawford County, Pennsylvania",27290,20383.0,16870,10833,6205,21085
2226,42041,"Cumberland County, Pennsylvania",38153,30119.0,23610,15796,7748,30405
2227,42043,"Dauphin County, Pennsylvania",35061,27727.0,22134,14890,7525,27536
2228,42045,"Delaware County, Pennsylvania",40740,32067.0,25040,17210,8044,32696
2229,42047,"Elk County, Pennsylvania",31333,22729.0,18174,10775,6422,24911
2230,42049,"Erie County, Pennsylvania",29001,22644.0,17932,12317,6654,22347
2231,42051,"Fayette County, Pennsylvania",27778,19209.0,15274,9791,5874,21904
2232,42053,"Forest County, Pennsylvania",17256,14325.0,14341,9349,5691,11565
2233,42055,"Franklin County, Pennsylvania",31887,25307.0,19339,13060,6675,25212
2234,42057,"Fulton County, Pennsylvania",28578,21739.0,16409,10267,5402,23176
2235,42059,"Greene County, Pennsylvania",28030,20258.0,14959,10005,5995,22035
2236,42061,"Huntingdon County, Pennsylvania",26454,20616.0,15379,10471,5233,21221
2237,42063,"Indiana County, Pennsylvania",26608,20587.0,15312,10260,6087,20521
2238,42065,"Jefferson County, Pennsylvania",26890,20305.0,16186,10580,6247,20643
2239,42067,"Juniata County, Pennsylvania",27221,20682.0,16142,10759,5703,21518
2240,42069,"Lackawanna County, Pennsylvania",30452,24152.0,18710,12358,6107,24345
2241,42071,"Lancaster County, Pennsylvania",33568,25854.0,20398,14235,7087,26481
2242,42073,"Lawrence County, Pennsylvania",28898,21467.0,16835,10830,6572,22326
2243,42075,"Lebanon County, Pennsylvania",30088,25525.0,19773,13209,6895,23193
2244,42077,"Lehigh County, Pennsylvania",34629,27301.0,21897,15458,7873,26756
2245,42079,"Luzerne County, Pennsylvania",29732,23245.0,18228,12002,6008,23724
2246,42081,"Lycoming County, Pennsylvania",28465,21802.0,17224,11714,6170,22295
2247,42083,"Mckean County, Pennsylvania",26635,21022.0,16777,10817,6133,20502
2248,42085,"Mercer County, Pennsylvania",27875,21765.0,17636,11336,6751,21124
2249,42087,"Mifflin County, Pennsylvania",26432,19085.0,15553,10609,5812,20620
2250,42089,"Monroe County, Pennsylvania",31954,24824.0,20011,13630,6771,25183
2251,42091,"Montgomery County, Pennsylvania",49905,40076.0,30898,21990,9734,40171
2252,42093,"Montour County, Pennsylvania",35407,26124.0,19302,13769,6353,29054
2253,42095,"Northampton County, Pennsylvania",37339,28362.0,21399,14562,7382,29957
2254,42097,"Northumberland County, Pennsylvania",27365,20654.0,16489,10819,5682,21683
2255,42099,"Perry County, Pennsylvania",33473,23701.0,18551,11941,6124,27349
2256,42101,"Philadelphia County, Pennsylvania",29644,21117.0,16509,12091,6053,23591
2257,42103,"Pike County, Pennsylvania",35746,27564.0,20315,13785,6869,28877
2258,42105,"Potter County, Pennsylvania",26439,20594.0,16070,9905,5125,21314
2259,42107,"Schuylkill County, Pennsylvania",27749,21408.0,17230,11193,5890,21859
2260,42109,"Snyder County, Pennsylvania",28151,21072.0,16756,10859,5754,22397
2261,42111,"Somerset County, Pennsylvania",27323,19903.0,15178,10422,6011,21312
2262,42113,"Sullivan County, Pennsylvania",31494,19718.0,16438,9839,5089,26405
2263,42115,"Susquehanna County, Pennsylvania",32608,22173.0,16435,10907,5615,26993
2264,42117,"Tioga County, Pennsylvania",26932,20358.0,15549,10290,5413,21519
2265,42119,"Union County, Pennsylvania",28884,21612.0,17918,11679,5789,23095
2266,42121,"Venango County, Pennsylvania",28002,20522.0,16252,10696,6684,21318
2267,42123,"Warren County, Pennsylvania",29272,22170.0,17862,12350,6563,22709
2268,42125,"Washington County, Pennsylvania",36554,26045.0,19935,12744,7070,29484
2269,42127,"Wayne County, Pennsylvania",28275,22525.0,16977,11257,5735,22540
2270,42129,"Westmoreland County, Pennsylvania",34992,25845.0,19674,12612,7104,27888
2271,42131,"Wyoming County, Pennsylvania",31899,22899.0,17452,11628,5849,26050
2272,42133,"York County, Pennsylvania",33587,27196.0,21086,14544,7326,26261
2273,44001,"Bristol County, Rhode Island",48321,35588.0,26503,17897,7610,40711
2274,44003,"Kent County, Rhode Island",40969,31221.0,23833,16390,7389,33580
2275,44005,"Newport County, Rhode Island",50514,36994.0,26779,16819,7138,43376
2276,44007,"Providence County, Rhode Island",32739,25169.0,19255,13871,6641,26098
2277,44009,"Washington County, Rhode Island",44325,34737.0,25530,16182,7087,37238
2278,45001,"Abbeville County, South Carolina",25598,16653.0,15370,10214,5379,20219
2279,45003,"Aiken County, South Carolina",29470,24172.0,18772,13127,6369,23101
2280,45005,"Allendale County, South Carolina",16985,14190.0,11293,7458,4317,12668
2281,45007,"Anderson County, South Carolina",28931,22117.0,18365,12027,6148,22783
2282,45009,"Bamberg County, South Carolina",19814,16236.0,12584,8438,4335,15479
2283,45011,"Barnwell County, South Carolina",22339,17592.0,15870,10611,5231,17108
2284,45013,"Beaufort County, South Carolina",41070,32731.0,25377,15213,6863,34207
2285,45015,"Berkeley County, South Carolina",30655,22865.0,16879,10942,5530,25125
2286,45017,"Calhoun County, South Carolina",26492,20845.0,17446,9983,4724,21768
2287,45019,"Charleston County, South Carolina",43141,29401.0,21393,13068,6358,36783
2288,45021,"Cherokee County, South Carolina",21636,17862.0,16421,10406,5552,16084
2289,45023,"Chester County, South Carolina",22955,17687.0,14709,9806,5310,17645
2290,45025,"Chesterfield County, South Carolina",22955,17162.0,14233,9455,5031,17924
2291,45027,"Clarendon County, South Carolina",23443,16562.0,13998,8181,4175,19268
2292,45029,"Colleton County, South Carolina",22218,17842.0,14831,9193,4633,17585
2293,45031,"Darlington County, South Carolina",23008,20096.0,16283,10510,5141,17867
2294,45033,"Dillon County, South Carolina",19131,14684.0,13272,8077,4162,14969
2295,45035,"Dorchester County, South Carolina",29856,24497.0,18840,11884,6013,23843
2296,45037,"Edgefield County, South Carolina",27213,19901.0,15415,10651,4750,22463
2297,45039,"Fairfield County, South Carolina",25698,18877.0,14911,9011,4496,21202
2298,45041,"Florence County, South Carolina",26636,21932.0,17876,11007,5526,21110
2299,45043,"Georgetown County, South Carolina",34629,23942.0,19805,11084,5445,29184
2300,45045,"Greenville County, South Carolina",34430,25931.0,22081,13918,6746,27684
2301,45047,"Greenwood County, South Carolina",26266,21728.0,17446,11429,6124,20142
2302,45049,"Hampton County, South Carolina",19460,16262.0,13129,8578,4827,14633
2303,45051,"Horry County, South Carolina",29055,24811.0,19949,12385,5803,23252
2304,45053,"Jasper County, South Carolina",24886,17997.0,14161,7984,4312,20574
2305,45055,"Kershaw County, South Carolina",26197,21777.0,18360,11937,6028,20169
2306,45057,"Lancaster County, South Carolina",33212,19308.0,16276,11041,5798,27414
2307,45059,"Laurens County, South Carolina",23482,18757.0,15761,10739,5509,17973
2308,45061,"Lee County, South Carolina",19510,12924.0,13896,7569,4272,15238
2309,45063,"Lexington County, South Carolina",32355,26393.0,21063,14259,6919,25436
2310,45065,"Mccormick County, South Carolina",26857,19411.0,14770,7929,4284,22573
2311,45067,"Marion County, South Carolina",18785,16653.0,13878,8185,4424,14361
2312,45069,"Marlboro County, South Carolina",16092,13817.0,13385,7948,4483,11609
2313,45071,"Newberry County, South Carolina",26501,21410.0,16045,10487,5834,20667
2314,45073,"Oconee County, South Carolina",31297,24055.0,18965,12352,5784,25513
2315,45075,"Orangeburg County, South Carolina",21337,17579.0,15057,9004,4713,16624
2316,45077,"Pickens County, South Carolina",28382,20647.0,17434,11427,6011,22371
2317,45079,"Richland County, South Carolina",30990,25805.0,20794,13243,6430,24560
2318,45081,"Saluda County, South Carolina",23097,18717.0,16328,9814,4723,18374
2319,45083,"Spartanburg County, South Carolina",27788,21924.0,18738,12218,6312,21476
2320,45085,"Sumter County, South Carolina",24541,18944.0,15657,9997,4774,19767
2321,45087,"Union County, South Carolina",24142,18495.0,15877,9669,5334,18808
2322,45089,"Williamsburg County, South Carolina",19438,13513.0,12794,7632,4094,15344
2323,45091,"York County, South Carolina",35285,25707.0,20536,13306,6371,28914
2324,46003,"Aurora County, South Dakota",35590,21291.0,13887,8129,4373,31217
2325,46005,"Beadle County, South Dakota",27898,23409.0,17832,10373,6259,21639
2326,46007,"Bennett County, South Dakota",18632,16153.0,10106,7841,3965,14667
2327,46009,"Bon Homme County, South Dakota",23877,20074.0,13892,8208,4609,19268
2328,46011,"Brookings County, South Dakota",28867,20995.0,17586,9926,5468,23399
2329,46013,"Brown County, South Dakota",33535,23878.0,18464,11579,6189,27346
2330,46015,"Brule County, South Dakota",34517,19779.0,14874,9681,4669,29848
2331,46017,"Buffalo County, South Dakota",12003,11410.0,5213,5067,2642,9361
2332,46019,"Butte County, South Dakota",28974,20418.0,13997,9843,5633,23341
2333,46021,"Campbell County, South Dakota",32029,22338.0,14117,8678,4042,27987
2334,46023,"Charles Mix County, South Dakota",23626,17403.0,11502,7475,4128,19498
2335,46025,"Clark County, South Dakota",31096,23909.0,15597,9280,4634,26462
2336,46027,"Clay County, South Dakota",30300,19518.0,14452,9160,5443,24857
2337,46029,"Codington County, South Dakota",30157,24781.0,18761,10508,6015,24142
2338,46031,"Corson County, South Dakota",16521,13359.0,8615,6299,3521,13000
2339,46033,"Custer County, South Dakota",35677,24353.0,17945,10942,5974,29703
2340,46035,"Davison County, South Dakota",30006,22794.0,17879,10105,5675,24331
2341,46037,"Day County, South Dakota",29356,20542.0,15856,9191,4825,24531
2342,46039,"Deuel County, South Dakota",30734,22276.0,15977,9117,4450,26284
2343,46041,"Dewey County, South Dakota",17387,15632.0,9251,6515,3943,13444
2344,46043,"Douglas County, South Dakota",30708,22200.0,13827,7869,3774,26934
2345,46045,"Edmunds County, South Dakota",34152,24268.0,16149,8792,4435,29717
2346,46047,"Fall River County, South Dakota",29139,21574.0,17048,10944,6197,22942
2347,46049,"Faulk County, South Dakota",26235,21898.0,14660,8653,4324,21911
2348,46051,"Grant County, South Dakota",32916,22887.0,16543,10394,5200,27716
2349,46053,"Gregory County, South Dakota",27378,21311.0,13656,8906,4417,22961
2350,46055,"Haakon County, South Dakota",23725,25877.0,16780,10117,4924,18801
2351,46057,"Hamlin County, South Dakota",27863,21558.0,16982,9086,4458,23405
2352,46059,"Hand County, South Dakota",34936,23238.0,18735,9305,4892,30044
2353,46061,"Hanson County, South Dakota",26710,21391.0,14778,9846,4029,22681
2354,46063,"Harding County, South Dakota",34028,22004.0,12794,8555,5132,28896
2355,46065,"Hughes County, South Dakota",34271,28236.0,20689,12263,7217,27054
2356,46067,"Hutchinson County, South Dakota",30941,21944.0,15922,9514,4800,26141
2357,46069,"Hyde County, South Dakota",33833,22995.0,16356,9648,4674,29159
2358,46071,"Jackson County, South Dakota",12847,14568.0,9981,6947,4623,8224
2359,46073,"Jerauld County, South Dakota",41875,24942.0,16856,9867,4794,37081
2360,46075,"Jones County, South Dakota",25885,24630.0,15896,9592,5171,20714
2361,46077,"Kingsbury County, South Dakota",34711,24660.0,16522,9857,4878,29833
2362,46079,"Lake County, South Dakota",31971,22447.0,16446,11388,5378,26593
2363,46081,"Lawrence County, South Dakota",34442,25465.0,17195,11378,5821,28621
2364,46083,"Lincoln County, South Dakota",38307,33261.0,22304,12246,6047,32260
2365,46085,"Lyman County, South Dakota",22937,16930.0,13862,9724,4763,18174
2366,46087,"Mccook County, South Dakota",30374,25502.0,16374,9542,4837,25537
2367,46089,"Mcpherson County, South Dakota",31765,19255.0,12748,8790,4277,27488
2368,46091,"Marshall County, South Dakota",37179,22441.0,15462,8799,4928,32251
2369,46093,"Meade County, South Dakota",29573,22045.0,17680,9725,5564,24009
2370,46095,"Mellette County, South Dakota",15298,16971.0,10362,6964,3581,11717
2371,46097,"Miner County, South Dakota",28294,25450.0,15155,9711,4201,24093
2372,46099,"Minnehaha County, South Dakota",32968,26392.0,20713,13345,7206,25762
2373,46101,"Moody County, South Dakota",30928,24948.0,16541,10169,5519,25409
2374,46103,"Pennington County, South Dakota",32540,25894.0,18938,12031,6594,25946
2375,46105,"Perkins County, South Dakota",32369,25780.0,15734,10982,5817,26552
2376,46107,"Potter County, South Dakota",30845,23986.0,17417,10177,4759,26086
2377,46109,"Roberts County, South Dakota",25523,19825.0,13428,7981,4480,21043
2378,46111,"Sanborn County, South Dakota",30277,21055.0,18301,8956,3918,26359
2379,46115,"Spink County, South Dakota",36453,25295.0,15728,9674,5141,31312
2380,46117,"Stanley County, South Dakota",44345,27435.0,20300,10759,6151,38194
2381,46119,"Sully County, South Dakota",40919,26596.0,17407,11559,4731,36188
2382,46121,"Todd County, South Dakota",10280,11010.0,7714,5043,3159,7121
2383,46123,"Tripp County, South Dakota",25877,21192.0,13776,10340,5077,20800
2384,46125,"Turner County, South Dakota",32123,22871.0,17343,9355,5358,26765
2385,46127,"Union County, South Dakota",44279,33783.0,24355,9997,5638,38641
2386,46129,"Walworth County, South Dakota",34827,23716.0,15492,10518,5370,29457
2387,46135,"Yankton County, South Dakota",32804,24776.0,17312,10305,6128,26676
2388,46137,"Ziebach County, South Dakota",18997,11069.0,7463,6132,3042,15955
2389,47001,"Anderson County, Tennessee",28633,24242.0,19009,13182,6987,21646
2390,47003,"Bedford County, Tennessee",26134,18471.0,16698,11311,6323,19811
2391,47005,"Benton County, Tennessee",23375,19114.0,14646,10046,5552,17823
2392,47007,"Bledsoe County, Tennessee",23120,12907.0,13889,8053,4495,18625
2393,47009,"Blount County, Tennessee",31231,24071.0,19416,12674,6544,24687
2394,47011,"Bradley County, Tennessee",26743,21444.0,18108,11768,5958,20785
2395,47013,"Campbell County, Tennessee",24670,16426.0,13301,8098,4530,20140
2396,47015,"Cannon County, Tennessee",26971,18076.0,16405,9863,5072,21899
2397,47017,"Carroll County, Tennessee",23384,19712.0,16251,10121,5306,18078
2398,47019,"Carter County, Tennessee",24631,17601.0,14678,9809,4923,19708
2399,47021,"Cheatham County, Tennessee",29302,24392.0,18882,11868,6243,23059
2400,47023,"Chester County, Tennessee",22150,17343.0,15756,8281,4913,17237
2401,47025,"Claiborne County, Tennessee",22562,17128.0,13032,8371,4253,18309
2402,47027,"Clay County, Tennessee",20395,18367.0,13320,8753,4176,16219
2403,47029,"Cocke County, Tennessee",22282,16957.0,13881,8574,4412,17870
2404,47031,"Coffee County, Tennessee",26572,20737.0,18137,11416,6153,20419
2405,47033,"Crockett County, Tennessee",24769,19742.0,14600,10636,4979,19790
2406,47035,"Cumberland County, Tennessee",26910,20544.0,16808,9782,4977,21933
2407,47037,"Davidson County, Tennessee",37958,27780.0,23069,15195,7578,30380
2408,47039,"Decatur County, Tennessee",24771,19757.0,17285,9345,5049,19722
2409,47041,"De Kalb County, Tennessee",25135,17976.0,17217,9570,5522,19613
2410,47043,"Dickson County, Tennessee",29125,21415.0,18043,11162,6044,23081
2411,47045,"Dyer County, Tennessee",29166,19169.0,16451,11270,5556,23610
2412,47047,"Fayette County, Tennessee",34721,26898.0,17969,9627,4299,30422
2413,47049,"Fentress County, Tennessee",20295,17291.0,12999,6927,3564,16731
2414,47051,"Franklin County, Tennessee",28008,20817.0,17987,10513,5544,22464
2415,47053,"Gibson County, Tennessee",23758,20065.0,16320,10277,5461,18297
2416,47055,"Giles County, Tennessee",26567,19778.0,17543,10983,5434,21133
2417,47057,"Grainger County, Tennessee",23937,16783.0,14505,8415,4403,19534
2418,47059,"Greene County, Tennessee",25319,18782.0,15746,10161,5216,20103
2419,47061,"Grundy County, Tennessee",20702,14000.0,12039,7227,4716,15986
2420,47063,"Hamblen County, Tennessee",23722,21162.0,17743,11127,5607,18115
2421,47065,"Hamilton County, Tennessee",34707,26588.0,21593,13619,6886,27821
2422,47067,"Hancock County, Tennessee",24237,13717.0,11986,6266,3054,21183
2423,47069,"Hardeman County, Tennessee",18936,15838.0,13349,8650,4412,14524
2424,47071,"Hardin County, Tennessee",24664,18122.0,15598,9654,5003,19661
2425,47073,"Hawkins County, Tennessee",25438,19600.0,16073,10358,5187,20251
2426,47075,"Haywood County, Tennessee",22830,17047.0,14669,8696,4435,18395
2427,47077,"Henderson County, Tennessee",23097,19988.0,17019,9564,5060,18037
2428,47079,"Henry County, Tennessee",24731,20687.0,15855,10423,5628,19103
2429,47081,"Hickman County, Tennessee",26431,18447.0,14446,9723,4973,21458
2430,47083,"Houston County, Tennessee",23836,17791.0,15614,9060,5105,18731
2431,47085,"Humphreys County, Tennessee",25307,20874.0,17757,10614,6029,19278
2432,47087,"Jackson County, Tennessee",21148,17452.0,15020,9159,4692,16456
2433,47089,"Jefferson County, Tennessee",25857,19680.0,16841,10562,5042,20815
2434,47091,"Johnson County, Tennessee",22955,16638.0,13388,7531,4084,18871
2435,47093,"Knox County, Tennessee",34338,27349.0,21875,14007,6895,27443
2436,47095,"Lake County, Tennessee",16152,11813.0,10794,8285,4687,11465
2437,47097,"Lauderdale County, Tennessee",19954,16006.0,13682,8607,4554,15400
2438,47099,"Lawrence County, Tennessee",22826,18086.0,15848,10094,5321,17505
2439,47101,"Lewis County, Tennessee",21800,17473.0,14664,8180,4350,17450
2440,47103,"Lincoln County, Tennessee",28519,22811.0,18837,10704,5323,23196
2441,47105,"Loudon County, Tennessee",34158,27046.0,21061,12006,6027,28131
2442,47107,"Mcminn County, Tennessee",25637,19796.0,16725,10508,5791,19846
2443,47109,"Mcnairy County, Tennessee",21903,18488.0,16385,9185,4968,16935
2444,47111,"Macon County, Tennessee",22881,16518.0,15286,10158,5575,17306
2445,47113,"Madison County, Tennessee",26619,22948.0,19389,11655,6010,20609
2446,47115,"Marion County, Tennessee",25717,20811.0,16419,9274,5317,20400
2447,47117,"Marshall County, Tennessee",26095,20157.0,17749,11248,6092,20003
2448,47119,"Maury County, Tennessee",29196,23136.0,19365,11942,6186,23010
2449,47121,"Meigs County, Tennessee",24299,18768.0,14551,9237,5511,18788
2450,47123,"Monroe County, Tennessee",25179,18651.0,14951,9080,4970,20209
2451,47125,"Montgomery County, Tennessee",28032,22092.0,17265,11056,5727,22305
2452,47127,"Moore County, Tennessee",30430,26678.0,19040,11545,5531,24899
2453,47129,"Morgan County, Tennessee",20258,17883.0,12925,7722,4753,15505
2454,47131,"Obion County, Tennessee",23336,21235.0,17409,11096,6116,17220
2455,47133,"Overton County, Tennessee",22864,17720.0,13910,8622,4563,18301
2456,47135,"Perry County, Tennessee",26222,17028.0,16969,9260,4992,21230
2457,47137,"Pickett County, Tennessee",26925,19327.0,14681,9564,3873,23052
2458,47139,"Polk County, Tennessee",28059,17481.0,16025,9311,4661,23398
2459,47141,"Putnam County, Tennessee",25208,19434.0,16927,11004,5558,19650
2460,47143,"Rhea County, Tennessee",23634,17655.0,15672,9333,5115,18519
2461,47145,"Roane County, Tennessee",32067,23196.0,18456,12015,6286,25781
2462,47147,"Robertson County, Tennessee",30620,22658.0,19054,12077,5846,24774
2463,47149,"Rutherford County, Tennessee",31195,24390.0,19938,12536,6346,24849
2464,47151,"Scott County, Tennessee",19970,15087.0,12927,7803,4697,15273
2465,47153,"Sequatchie County, Tennessee",22931,18094.0,16468,9377,4563,18368
2466,47155,"Sevier County, Tennessee",26919,22047.0,18064,10848,5657,21262
2467,47157,"Shelby County, Tennessee",31272,25002.0,20856,13330,6697,24575
2468,47159,"Smith County, Tennessee",28134,21026.0,17473,10950,5812,22322
2469,47161,"Stewart County, Tennessee",25166,20670.0,16302,9935,4772,20394
2470,47163,"Sullivan County, Tennessee",28790,23263.0,19202,12725,6497,22293
2471,47165,"Sumner County, Tennessee",34353,26014.0,21164,13497,6833,27520
2472,47167,"Tipton County, Tennessee",28027,21585.0,17952,9796,5287,22740
2473,47169,"Trousdale County, Tennessee",24036,19996.0,15838,9618,6226,17810
2474,47171,"Unicoi County, Tennessee",23817,20540.0,15612,10727,5237,18580
2475,47173,"Union County, Tennessee",24268,16155.0,13375,8351,4399,19869
2476,47175,"Van Buren County, Tennessee",22051,17160.0,17497,8186,4903,17148
2477,47177,"Warren County, Tennessee",23143,18508.0,15759,10472,5269,17874
2478,47179,"Washington County, Tennessee",29850,24114.0,19085,11949,6397,23453
2479,47181,"Wayne County, Tennessee",22231,15814.0,14472,8240,4638,17593
2480,47183,"Weakley County, Tennessee",22841,18895.0,15408,9857,5203,17638
2481,47185,"White County, Tennessee",23820,17880.0,14791,9299,5089,18731
2482,47187,"Williamson County, Tennessee",53320,41220.0,32496,19339,8489,44831
2483,47189,"Wilson County, Tennessee",36576,27814.0,22739,13681,6790,29786
2484,48001,"Anderson County, Texas",19168,17465.0,13838,9384,5889,13279
2485,48003,"Andrews County, Texas",32217,29605.0,15916,10361,7003,25214
2486,48005,"Angelina County, Texas",23878,20104.0,15876,11248,6229,17649
2487,48007,"Aransas County, Texas",32050,25610.0,18560,11394,6820,25230
2488,48009,"Archer County, Texas",34557,23882.0,19300,11719,7080,27477
2489,48011,"Armstrong County, Texas",32740,24195.0,17151,11212,7262,25478
2490,48013,"Atascosa County, Texas",25385,18461.0,14276,8447,4949,20436
2491,48015,"Austin County, Texas",31592,26959.0,18140,11837,7000,24592
2492,48017,"Bailey County, Texas",23594,18275.0,12979,10043,5682,17912
2493,48019,"Bandera County, Texas",32993,24249.0,19635,12798,6457,26536
2494,48021,"Bastrop County, Texas",28473,22918.0,18146,10300,5864,22609
2495,48023,"Baylor County, Texas",26220,22894.0,16384,11040,6257,19963
2496,48025,"Bee County, Texas",18568,14188.0,10625,8619,5392,13176
2497,48027,"Bell County, Texas",27171,22722.0,17219,10908,5810,21361
2498,48029,"Bexar County, Texas",28313,23225.0,18363,11827,6135,22178
2499,48031,"Blanco County, Texas",40737,27010.0,19721,12388,7003,33734
2500,48033,"Borden County, Texas",33412,40916.0,18364,17533,7008,26404
2501,48035,"Bosque County, Texas",28417,21269.0,17455,10992,5994,22423
2502,48037,"Bowie County, Texas",27572,22293.0,17357,11846,6246,21326
2503,48039,"Brazoria County, Texas",35437,27529.0,20021,13468,8016,27421
2504,48041,"Brazos County, Texas",28679,21018.0,16212,10987,5903,22776
2505,48043,"Brewster County, Texas",29696,23577.0,15183,10730,4837,24859
2506,48045,"Briscoe County, Texas",24991,17652.0,14218,10058,5506,19485
2507,48047,"Brooks County, Texas",15817,14728.0,10234,6623,4515,11302
2508,48049,"Brown County, Texas",26989,20586.0,15624,9797,5972,21017
2509,48051,"Burleson County, Texas",32382,21379.0,16616,9354,5675,26707
2510,48053,"Burnet County, Texas",31664,25245.0,18850,11530,6003,25661
2511,48055,"Caldwell County, Texas",25760,18106.0,15099,9242,4915,20845
2512,48057,"Calhoun County, Texas",28653,22835.0,17125,10374,6898,21755
2513,48059,"Callahan County, Texas",26546,22300.0,15204,10353,6105,20441
2514,48061,"Cameron County, Texas",18247,13695.0,10960,7125,4336,13911
2515,48063,"Camp County, Texas",24038,18710.0,16500,9936,6236,17802
2516,48065,"Carson County, Texas",35045,24977.0,19368,11710,7240,27805
2517,48067,"Cass County, Texas",27161,20137.0,15777,9391,5827,21334
2518,48069,"Castro County, Texas",23784,16073.0,14457,7510,4850,18934
2519,48071,"Chambers County, Texas",37276,26453.0,19863,12218,7323,29953
2520,48073,"Cherokee County, Texas",23888,17230.0,13980,9195,5887,18001
2521,48075,"Childress County, Texas",23373,16338.0,12452,9888,5795,17578
2522,48077,"Clay County, Texas",31217,24565.0,16361,10978,6861,24356
2523,48079,"Cochran County, Texas",21123,16018.0,13125,8533,5624,15499
2524,48081,"Coke County, Texas",27033,18384.0,16734,10220,6835,20198
2525,48083,"Coleman County, Texas",29003,16494.0,14911,9353,5501,23502
2526,48085,"Collin County, Texas",46240,37362.0,33345,20503,8444,37796
2527,48087,"Collingsworth County, Texas",26472,21726.0,15318,9425,5591,20881
2528,48089,"Colorado County, Texas",28868,22676.0,16910,10379,6608,22260
2529,48091,"Comal County, Texas",39942,31862.0,21914,13400,7164,32778
2530,48093,"Comanche County, Texas",27419,18086.0,14677,9679,5925,21494
2531,48095,"Concho County, Texas",22167,17731.0,15727,8126,5917,16250
2532,48097,"Cooke County, Texas",32078,23598.0,17889,11594,6639,25439
2533,48099,"Coryell County, Texas",22477,18936.0,14410,8924,4994,17483
2534,48101,"Cottle County, Texas",23798,17385.0,16212,10289,7263,16535
2535,48103,"Crane County, Texas",26401,20185.0,15374,10751,6199,20202
2536,48105,"Crockett County, Texas",23655,24194.0,14414,10232,6767,16888
2537,48107,"Crosby County, Texas",24165,17940.0,14445,8598,5211,18954
2538,48109,"Culberson County, Texas",16353,16060.0,11493,7632,4290,12063
2539,48111,"Dallam County, Texas",29031,18940.0,13653,9250,5242,23789
2540,48113,"Dallas County, Texas",33604,26185.0,22603,16243,8667,24937
2541,48115,"Dawson County, Texas",21109,15288.0,15011,9535,5983,15126
2542,48117,"Deaf Smith County, Texas",21588,16687.0,13119,9296,5691,15897
2543,48119,"Delta County, Texas",28197,20837.0,15080,9859,5233,22964
2544,48121,"Denton County, Texas",42498,32538.0,26895,16105,8116,34382
2545,48123,"De Witt County, Texas",27359,20020.0,14780,9564,5583,21776
2546,48125,"Dickens County, Texas",25750,18642.0,13156,8465,4758,20992
2547,48127,"Dimmit County, Texas",16248,14045.0,9765,5386,3922,12326
2548,48129,"Donley County, Texas",26425,20137.0,15958,9388,6279,20146
2549,48131,"Duval County, Texas",19501,15134.0,11324,7126,4310,15191
2550,48133,"Eastland County, Texas",26018,17973.0,14870,8729,5608,20410
2551,48135,"Ector County, Texas",29510,22859.0,15031,10897,7754,21756
2552,48137,"Edwards County, Texas",20655,31109.0,12691,7537,4939,15716
2553,48139,"Ellis County, Texas",33629,25346.0,20212,12199,6467,27162
2554,48141,"El Paso County, Texas",22490,16768.0,13421,9150,5306,17184
2555,48143,"Erath County, Texas",28166,20903.0,16655,10832,6870,21296
2556,48145,"Falls County, Texas",23131,14979.0,14311,8600,5078,18053
2557,48147,"Fannin County, Texas",28882,20221.0,16066,10298,5862,23020
2558,48149,"Fayette County, Texas",30236,26898.0,18888,10769,6110,24126
2559,48151,"Fisher County, Texas",30304,20516.0,15120,9760,7051,23253
2560,48153,"Floyd County, Texas",24509,18093.0,14206,9564,5363,19146
2561,48155,"Foard County, Texas",27668,18368.0,14799,9228,6170,21498
2562,48157,"Fort Bend County, Texas",40607,32016.0,24985,16056,8966,31641
2563,48159,"Franklin County, Texas",31988,23821.0,17563,12370,6696,25292
2564,48161,"Freestone County, Texas",25500,23235.0,16338,10735,6078,19422
2565,48163,"Frio County, Texas",20036,15036.0,16069,6629,4137,15899
2566,48165,"Gaines County, Texas",22978,22785.0,13088,9204,5965,17013
2567,48167,"Galveston County, Texas",37530,28959.0,21568,13993,7891,29639
2568,48169,"Garza County, Texas",17723,16185.0,12704,9112,6420,11303
2569,48171,"Gillespie County, Texas",34689,28072.0,20423,12046,6054,28635
2570,48173,"Glasscock County, Texas",30062,26104.0,18279,16219,6546,23516
2571,48175,"Goliad County, Texas",30038,28120.0,17126,10875,5544,24494
2572,48177,"Gonzales County, Texas",28313,18716.0,14269,9252,5187,23126
2573,48179,"Gray County, Texas",27760,20567.0,16702,12771,7845,19915
2574,48181,"Grayson County, Texas",29157,23242.0,18862,12201,6934,22223
2575,48183,"Gregg County, Texas",27809,23024.0,18449,12457,7157,20652
2576,48185,"Grimes County, Texas",26734,17365.0,14368,8920,5825,20909
2577,48187,"Guadalupe County, Texas",32406,25218.0,18430,11330,5995,26411
2578,48189,"Hale County, Texas",21303,16322.0,13655,9932,5652,15651
2579,48191,"Hall County, Texas",24009,20126.0,13210,9376,5539,18470
2580,48193,"Hamilton County, Texas",27147,22429.0,16800,11193,5855,21292
2581,48195,"Hansford County, Texas",22331,21095.0,17408,12136,8136,14195
2582,48197,"Hardeman County, Texas",26659,17401.0,16824,10502,6626,20033
2583,48199,"Hardin County, Texas",29451,23965.0,17962,11178,6829,22622
2584,48201,"Harris County, Texas",33459,26788.0,21435,15202,9062,24397
2585,48203,"Harrison County, Texas",26621,22019.0,16702,10173,6050,20571
2586,48205,"Hartley County, Texas",21862,24616.0,18067,14254,8172,13690
2587,48207,"Haskell County, Texas",27937,22734.0,14918,10099,6427,21510
2588,48209,"Hays County, Texas",32988,25998.0,19931,11422,5438,27550
2589,48211,"Hemphill County, Texas",34702,29343.0,16929,14244,7808,26894
2590,48213,"Henderson County, Texas",27069,21580.0,17772,10692,6493,20576
2591,48215,"Hidalgo County, Texas",17816,13480.0,9899,6630,4040,13776
2592,48217,"Hill County, Texas",26938,20554.0,15514,10703,5833,21105
2593,48219,"Hockley County, Texas",24816,20255.0,15022,10648,5825,18991
2594,48221,"Hood County, Texas",36091,30687.0,22261,14961,8112,27979
2595,48223,"Hopkins County, Texas",26915,21163.0,17182,11049,6210,20705
2596,48225,"Houston County, Texas",21669,18813.0,14525,9965,4780,16889
2597,48227,"Howard County, Texas",25531,17832.0,15027,10644,6876,18655
2598,48229,"Hudspeth County, Texas",13267,11485.0,9549,7994,4480,8787
2599,48231,"Hunt County, Texas",27338,21646.0,17554,11845,6136,21202
2600,48233,"Hutchinson County, Texas",26387,21075.0,17317,11677,7735,18652
2601,48235,"Irion County, Texas",29460,31857.0,20515,11659,7015,22445
2602,48237,"Jack County, Texas",25619,21349.0,15210,11010,6645,18974
2603,48239,"Jackson County, Texas",25701,24337.0,16693,10225,6226,19475
2604,48241,"Jasper County, Texas",25690,19182.0,15636,9659,5913,19777
2605,48243,"Jeff Davis County, Texas",23118,22007.0,18846,9975,5675,17443
2606,48245,"Jefferson County, Texas",27409,22095.0,17571,12348,7601,19808
2607,48247,"Jim Hogg County, Texas",16407,17163.0,12185,6852,4772,11635
2608,48249,"Jim Wells County, Texas",21749,16976.0,12252,8080,5601,16148
2609,48251,"Johnson County, Texas",28290,23669.0,18400,12054,6979,21311
2610,48253,"Jones County, Texas",17642,15880.0,13656,9910,6264,11378
2611,48255,"Karnes County, Texas",25978,15949.0,13603,8229,5343,20635
2612,48257,"Kaufman County, Texas",29147,23909.0,18827,11567,6510,22637
2613,48259,"Kendall County, Texas",47724,36418.0,24619,13426,7133,40591
2614,48261,"Kenedy County, Texas",15058,16655.0,17959,9212,10078,4980
2615,48263,"Kent County, Texas",30835,27021.0,17626,10087,6155,24680
2616,48265,"Kerr County, Texas",32361,25454.0,19767,12899,7336,25025
2617,48267,"Kimble County, Texas",36406,27118.0,17127,11372,5535,30871
2618,48269,"King County, Texas",17971,39511.0,12321,12027,5511,12460
2619,48271,"Kinney County, Texas",26715,14207.0,15350,7931,4146,22569
2620,48273,"Kleberg County, Texas",23021,18580.0,13542,9580,5577,17444
2621,48275,"Knox County, Texas",24273,20375.0,13443,9241,6832,17441
2622,48277,"Lamar County, Texas",24826,20588.0,17000,10511,5577,19249
2623,48279,"Lamb County, Texas",21502,17553.0,15169,9362,5768,15734
2624,48281,"Lampasas County, Texas",29695,22943.0,17184,10586,5731,23964
2625,48283,"La Salle County, Texas",17177,13542.0,9692,8130,4241,12936
2626,48285,"Lavaca County, Texas",31241,23168.0,16398,10294,5641,25600
2627,48287,"Lee County, Texas",27216,23074.0,17163,10252,5828,21388
2628,48289,"Leon County, Texas",28976,22484.0,17599,10385,5725,23251
2629,48291,"Liberty County, Texas",23433,18807.0,15539,9928,6677,16756
2630,48293,"Limestone County, Texas",22808,18420.0,14352,9745,5183,17625
2631,48295,"Lipscomb County, Texas",28736,24839.0,16328,11997,7017,21719
2632,48297,"Live Oak County, Texas",23632,21540.0,15886,10055,6728,16904
2633,48299,"Llano County, Texas",41499,29027.0,23547,12448,7550,33949
2634,48301,"Loving County, Texas",37693,42220.0,24084,12482,21673,16020
2635,48303,"Lubbock County, Texas",28880,22831.0,17323,12008,6926,21954
2636,48305,"Lynn County, Texas",25871,19752.0,14090,9909,4938,20933
2637,48307,"Mcculloch County, Texas",25567,20116.0,14579,8847,5414,20153
2638,48309,"Mclennan County, Texas",26754,20652.0,17174,11185,6236,20518
2639,48311,"Mcmullen County, Texas",31191,21358.0,22258,13485,8116,23075
2640,48313,"Madison County, Texas",22183,14245.0,14056,8767,5010,17173
2641,48315,"Marion County, Texas",25798,20125.0,14535,9197,4917,20881
2642,48317,"Martin County, Texas",32242,19695.0,15647,9867,6930,25312
2643,48319,"Mason County, Texas",34196,23555.0,20931,8575,5869,28327
2644,48321,"Matagorda County, Texas",25206,22623.0,15709,11374,7142,18064
2645,48323,"Maverick County, Texas",17545,12444.0,8758,5184,3100,14445
2646,48325,"Medina County, Texas",27200,20604.0,15210,9820,5138,22062
2647,48327,"Menard County, Texas",29080,23362.0,15987,9318,4865,24215
2648,48329,"Midland County, Texas",40478,30956.0,20369,15417,10060,30418
2649,48331,"Milam County, Texas",27585,21509.0,16920,10341,5503,22082
2650,48333,"Mills County, Texas",27619,20438.0,15915,10374,5233,22386
2651,48335,"Mitchell County, Texas",22950,13358.0,14043,9581,6060,16890
2652,48337,"Montague County, Texas",28986,22328.0,17115,10420,6006,22980
2653,48339,"Montgomery County, Texas",41892,31959.0,24544,14283,8173,33719
2654,48341,"Moore County, Texas",22646,18239.0,15214,11195,7019,15627
2655,48343,"Morris County, Texas",22868,20292.0,15612,10344,6366,16502
2656,48345,"Motley County, Texas",27075,19754.0,16584,9004,5930,21145
2657,48347,"Nacogdoches County, Texas",24031,18180.0,15437,9829,5854,18177
2658,48349,"Navarro County, Texas",24133,20539.0,15266,10468,6034,18099
2659,48351,"Newton County, Texas",21836,17721.0,13381,7760,5113,16723
2660,48353,"Nolan County, Texas",25703,19973.0,14077,9738,6307,19396
2661,48355,"Nueces County, Texas",28078,22558.0,17036,11396,6609,21469
2662,48357,"Ochiltree County, Texas",23215,21143.0,16707,13325,8454,14761
2663,48359,"Oldham County, Texas",27166,22504.0,14806,10577,5083,22083
2664,48361,"Orange County, Texas",31260,23155.0,17554,11493,7160,24100
2665,48363,"Palo Pinto County, Texas",27473,21551.0,15454,9979,6650,20823
2666,48365,"Panola County, Texas",27267,22846.0,15439,10695,6225,21042
2667,48367,"Parker County, Texas",36420,28539.0,20305,12966,7043,29377
2668,48369,"Parmer County, Texas",26269,16926.0,14184,9087,5252,21017
2669,48371,"Pecos County, Texas",23201,16717.0,12212,9133,5708,17493
2670,48373,"Polk County, Texas",24479,16961.0,15834,9974,5527,18952
2671,48375,"Potter County, Texas",23245,18725.0,14947,10230,6691,16554
2672,48377,"Presidio County, Texas",15687,15635.0,9558,6347,3751,11936
2673,48379,"Rains County, Texas",28919,20855.0,16442,10711,6481,22438
2674,48381,"Randall County, Texas",34527,28668.0,21840,15369,9044,25483
2675,48383,"Reagan County, Texas",25126,23028.0,13174,10243,6466,18660
2676,48385,"Real County, Texas",22588,15074.0,14321,8184,4636,17952
2677,48387,"Red River County, Texas",23895,18105.0,15058,8482,5033,18862
2678,48389,"Reeves County, Texas",22670,13112.0,10811,7765,4908,17762
2679,48391,"Refugio County, Texas",24893,18638.0,15481,10496,6186,18707
2680,48393,"Roberts County, Texas",29673,29291.0,20923,15679,8114,21559
2681,48395,"Robertson County, Texas",27245,21113.0,14714,9705,5460,21785
2682,48397,"Rockwall County, Texas",45461,33274.0,28573,17982,9817,35644
2683,48399,"Runnels County, Texas",24191,20056.0,13577,9602,5868,18323
2684,48401,"Rusk County, Texas",27267,22392.0,16674,10127,6191,21076
2685,48403,"Sabine County, Texas",27345,18155.0,15821,10539,5131,22214
2686,48405,"San Augustine County, Texas",23385,17184.0,15548,8151,5144,18241
2687,48407,"San Jacinto County, Texas",24618,21453.0,16144,9657,5422,19196
2688,48409,"San Patricio County, Texas",26714,20766.0,15425,9425,6028,20686
2689,48411,"San Saba County, Texas",25201,19721.0,15309,10785,5294,19907
2690,48413,"Schleicher County, Texas",24030,21299.0,15969,10615,6610,17420
2691,48415,"Scurry County, Texas",24238,22424.0,15871,10333,7063,17175
2692,48417,"Shackelford County, Texas",27822,22346.0,16341,11487,7009,20813
2693,48419,"Shelby County, Texas",22404,20103.0,15186,9510,5576,16828
2694,48421,"Sherman County, Texas",36988,21587.0,17210,10396,10504,26484
2695,48423,"Smith County, Texas",28858,25374.0,19072,12742,7115,21743
2696,48425,"Somervell County, Texas",32998,26314.0,18367,11892,6963,26035
2697,48427,"Starr County, Texas",14545,11659.0,7069,4152,2668,11877
2698,48429,"Stephens County, Texas",25592,19573.0,15475,10343,6374,19218
2699,48431,"Sterling County, Texas",27551,20640.0,16972,12698,7138,20413
2700,48433,"Stonewall County, Texas",23300,25177.0,16094,10240,5972,17328
2701,48435,"Sutton County, Texas",25650,23325.0,17105,10926,8144,17506
2702,48437,"Swisher County, Texas",18310,16513.0,14326,9692,5355,12955
2703,48439,"Tarrant County, Texas",34045,27333.0,22548,15178,7965,26080
2704,48441,"Taylor County, Texas",28071,22606.0,17176,11791,6806,21265
2705,48443,"Terrell County, Texas",26056,18871.0,13721,10146,7069,18987
2706,48445,"Terry County, Texas",21048,22306.0,13860,10859,5799,15249
2707,48447,"Throckmorton County, Texas",31628,20677.0,17719,10505,6397,25231
2708,48449,"Titus County, Texas",22077,17520.0,15501,11163,6438,15639
2709,48451,"Tom Green County, Texas",29547,22292.0,17325,11482,6798,22749
2710,48453,"Travis County, Texas",45453,31785.0,25883,15123,7540,37913
2711,48455,"Trinity County, Texas",26347,19828.0,15472,9605,5403,20944
2712,48457,"Tyler County, Texas",21632,19450.0,15367,9733,5834,15798
2713,48459,"Upshur County, Texas",26648,21946.0,16358,10254,6038,20610
2714,48461,"Upton County, Texas",25994,23112.0,14274,9500,5927,20067
2715,48463,"Uvalde County, Texas",21036,17842.0,12557,8625,4697,16339
2716,48465,"Val Verde County, Texas",21082,16615.0,12096,7904,4542,16540
2717,48467,"Van Zandt County, Texas",30111,20989.0,16930,10130,6028,24083
2718,48469,"Victoria County, Texas",29424,24146.0,18379,12196,7124,22300
2719,48471,"Walker County, Texas",18598,13920.0,14508,10090,5644,12954
2720,48473,"Waller County, Texas",27033,21621.0,16338,10294,6004,21029
2721,48475,"Ward County, Texas",26209,20055.0,14393,9971,6097,20112
2722,48477,"Washington County, Texas",32649,25464.0,17384,11036,6744,25905
2723,48479,"Webb County, Texas",19048,14163.0,10759,6771,3980,15068
2724,48481,"Wharton County, Texas",26724,21049.0,15388,10911,6285,20439
2725,48483,"Wheeler County, Texas",27737,27282.0,16083,10370,7484,20253
2726,48485,"Wichita County, Texas",25568,22837.0,16965,11635,7059,18509
2727,48487,"Wilbarger County, Texas",23340,19916.0,16520,9823,6451,16889
2728,48489,"Willacy County, Texas",18244,10800.0,9421,6074,4133,14111
2729,48491,"Williamson County, Texas",38494,29663.0,24547,13490,7038,31456
2730,48493,"Wilson County, Texas",33972,25149.0,17253,9728,5234,28738
2731,48495,"Winkler County, Texas",25141,19309.0,13725,9843,6125,19016
2732,48497,"Wise County, Texas",30693,24075.0,17729,11307,6671,24022
2733,48499,"Wood County, Texas",30587,21682.0,17702,10937,6180,24407
2734,48501,"Yoakum County, Texas",25417,19937.0,14504,10592,6343,19074
2735,48503,"Young County, Texas",30020,24656.0,16710,11368,8107,21913
2736,48505,"Zapata County, Texas",18587,13915.0,10486,6541,4395,14192
2737,48507,"Zavala County, Texas",16738,10180.0,10034,4818,3202,13536
2738,49001,"Beaver County, Utah",24540,16131.0,14957,8558,4908,19632
2739,49003,"Box Elder County, Utah",25835,20465.0,15625,11045,5798,20037
2740,49005,"Cache County, Utah",24221,19670.0,15094,9544,5401,18820
2741,49007,"Carbon County, Utah",23613,20260.0,15325,10225,6883,16730
2742,49009,"Daggett County, Utah",27568,22862.0,15511,9575,5662,21906
2743,49011,"Davis County, Utah",32819,25244.0,19506,11611,6275,26544
2744,49013,"Duchesne County, Utah",25086,21787.0,12326,8197,5531,19555
2745,49015,"Emery County, Utah",24372,19968.0,14243,9257,5896,18476
2746,49017,"Garfield County, Utah",23926,23187.0,13439,8248,4969,18957
2747,49019,"Grand County, Utah",30948,20611.0,17356,9899,6495,24453
2748,49021,"Iron County, Utah",22409,16898.0,13568,8539,5158,17251
2749,49023,"Juab County, Utah",23467,18193.0,12790,8332,5223,18244
2750,49025,"Kane County, Utah",28142,25155.0,15455,8721,4528,23614
2751,49027,"Millard County, Utah",25479,18839.0,13408,8574,4809,20670
2752,49029,"Morgan County, Utah",34280,24276.0,17684,10448,6237,28043
2753,49031,"Piute County, Utah",18148,16140.0,12697,8160,4893,13255
2754,49033,"Rich County, Utah",23943,25376.0,16267,8610,5821,18122
2755,49035,"Salt Lake County, Utah",34640,25041.0,20190,12222,7013,27627
2756,49037,"San Juan County, Utah",20088,15150.0,10229,5907,3701,16387
2757,49039,"Sanpete County, Utah",21254,15731.0,12442,7585,4531,16723
2758,49041,"Sevier County, Utah",24041,18856.0,14180,8615,5481,18560
2759,49043,"Summit County, Utah",57308,40270.0,33767,16739,8454,48854
2760,49045,"Tooele County, Utah",27702,22020.0,16321,10568,6458,21244
2761,49047,"Uintah County, Utah",24578,24160.0,13571,8379,5768,18810
2762,49049,"Utah County, Utah",27365,20210.0,15557,9051,5199,22166
2763,49051,"Wasatch County, Utah",38622,26873.0,19869,10722,5466,33156
2764,49053,"Washington County, Utah",29886,21378.0,15873,9450,4869,25017
2765,49055,"Wayne County, Utah",23184,19829.0,15392,7692,4675,18509
2766,49057,"Weber County, Utah",29186,22849.0,18246,11637,6585,22601
2767,50001,"Addison County, Vermont",36390,26599.0,19539,12717,5574,30816
2768,50003,"Bennington County, Vermont",34435,27962.0,21193,13543,6474,27961
2769,50005,"Caledonia County, Vermont",30902,22504.0,16976,11425,5453,25449
2770,50007,"Chittenden County, Vermont",40809,31095.0,23501,16096,6925,33884
2771,50009,"Essex County, Vermont",27583,20040.0,14388,9854,4929,22654
2772,50011,"Franklin County, Vermont",31305,24767.0,17816,11678,5561,25744
2773,50013,"Grand Isle County, Vermont",41530,30499.0,22207,13940,5896,35634
2774,50015,"Lamoille County, Vermont",38794,27164.0,20972,12519,5586,33208
2775,50017,"Orange County, Vermont",33384,25951.0,18784,11898,5245,28139
2776,50019,"Orleans County, Vermont",29116,20652.0,16518,10458,5209,23907
2777,50021,"Rutland County, Vermont",31831,25426.0,18874,12780,6089,25742
2778,50023,"Washington County, Vermont",36071,28337.0,21113,13547,6078,29993
2779,50025,"Windham County, Vermont",34313,27247.0,20533,13134,6323,27990
2780,50027,"Windsor County, Vermont",37145,29053.0,22369,14262,6760,30385
2781,51001,"Accomack County, Virginia",27012,22766.0,16309,10506,5413,21599
2782,51003,"Albemarle County, Virginia",46241,36685.0,28852,17448,7852,38389
2783,51005,"Alleghany County, Virginia",28048,22013.0,19635,11606,6085,21963
2784,51007,"Amelia County, Virginia",32799,24197.0,18858,11605,5370,27429
2785,51009,"Amherst County, Virginia",28866,21097.0,16952,11185,5752,23114
2786,51011,"Appomattox County, Virginia",27889,22388.0,18086,10795,6233,21656
2787,51013,"Arlington County, Virginia",73078,57724.0,37706,25633,12562,60516
2788,51015,"Augusta County, Virginia",30493,23571.0,19744,12751,6359,24134
2789,51017,"Bath County, Virginia",34463,22083.0,23092,11369,6211,28252
2790,51019,"Bedford County, Virginia",34565,27732.0,21582,14305,6171,28394
2791,51021,"Bland County, Virginia",23664,20468.0,17744,9765,4885,18779
2792,51023,"Botetourt County, Virginia",37357,29540.0,22218,13810,6762,30595
2793,51025,"Brunswick County, Virginia",24493,16739.0,14890,8872,4534,19959
2794,51027,"Buchanan County, Virginia",22092,16742.0,12788,9621,5444,16648
2795,51029,"Buckingham County, Virginia",23045,16752.0,13669,9165,4605,18440
2796,51031,"Campbell County, Virginia",28173,22044.0,18134,12061,6333,21840
2797,51033,"Caroline County, Virginia",35588,25024.0,18342,11837,5431,30157
2798,51035,"Carroll County, Virginia",24476,18670.0,16475,9693,4998,19478
2799,51036,"Charles City County, Virginia",36325,23955.0,19182,11384,5718,30607
2800,51037,"Charlotte County, Virginia",24337,17348.0,14717,9008,4540,19797
2801,51041,"Chesterfield County, Virginia",42734,31711.0,25286,17423,8419,34315
2802,51043,"Clarke County, Virginia",42327,34630.0,24844,15657,7473,34854
2803,51045,"Craig County, Virginia",30433,23461.0,17322,11186,5481,24952
2804,51047,"Culpeper County, Virginia",37507,27507.0,20162,14122,6232,31275
2805,51049,"Cumberland County, Virginia",29160,19691.0,15103,10295,4630,24530
2806,51051,"Dickenson County, Virginia",25485,16278.0,12822,8067,5151,20334
2807,51053,"Dinwiddie County, Virginia",30351,23423.0,19122,12212,5487,24864
2808,51057,"Essex County, Virginia",26114,23795.0,17994,11529,5920,20194
2809,51059,"Fairfax County, Virginia",58338,49001.0,36888,24833,11497,46841
2810,51061,"Fauquier County, Virginia",47642,38710.0,28757,19195,7464,40178
2811,51063,"Floyd County, Virginia",27306,21425.0,16345,10532,5186,22120
2812,51065,"Fluvanna County, Virginia",44149,29407.0,20338,12977,5446,38703
2813,51067,"Franklin County, Virginia",32084,23527.0,19605,11936,5674,26410
2814,51069,"Frederick County, Virginia",38442,27977.0,21080,13671,6503,31939
2815,51071,"Giles County, Virginia",27679,20985.0,18396,11462,5640,22039
2816,51073,"Gloucester County, Virginia",34565,27395.0,19990,13122,6566,27999
2817,51075,"Goochland County, Virginia",52605,38553.0,29105,18312,7263,45342
2818,51077,"Grayson County, Virginia",24770,19499.0,16768,8966,5266,19504
2819,51079,"Greene County, Virginia",33913,24969.0,19478,12268,5820,28093
2820,51081,"Greensville County, Virginia",20011,17631.0,14632,9504,4630,15381
2821,51083,"Halifax County, Virginia",24368,19909.0,16353,9568,4813,19555
2822,51085,"Hanover County, Virginia",43003,34201.0,25120,16463,7636,35367
2823,51087,"Henrico County, Virginia",41437,33001.0,26410,18019,8562,32875
2824,51089,"Henry County, Virginia",23051,19206.0,17110,11491,6033,17018
2825,51091,"Highland County, Virginia",30911,25690.0,15976,10828,6047,24864
2826,51093,"Isle Of Wight County, Virginia",39024,29547.0,20235,12274,6192,32832
2827,51095,"James City County, Virginia",45862,38162.0,29256,18139,7452,38410
2828,51097,"King And Queen County, Virginia",34873,21777.0,17236,11278,5745,29128
2829,51099,"King George County, Virginia",38926,32630.0,21562,15365,6720,32206
2830,51101,"King William County, Virginia",33261,26853.0,21928,13294,6601,26660
2831,51103,"Lancaster County, Virginia",48280,29275.0,24663,17698,6755,41525
2832,51105,"Lee County, Virginia",19126,16513.0,13625,7837,4540,14586
2833,51107,"Loudoun County, Virginia",57513,45356.0,33530,20757,8989,48524
2834,51109,"Louisa County, Virginia",35894,27562.0,19479,12390,5488,30406
2835,51111,"Lunenburg County, Virginia",21602,17744.0,14951,9158,5125,16477
2836,51113,"Madison County, Virginia",34434,26081.0,18636,11145,5205,29229
2837,51115,"Mathews County, Virginia",43918,27011.0,23610,13671,7171,36747
2838,51117,"Mecklenburg County, Virginia",28048,20162.0,17171,10508,5266,22782
2839,51119,"Middlesex County, Virginia",33992,28539.0,22708,14834,5887,28105
2840,51121,"Montgomery County, Virginia",30581,22040.0,17077,10979,5657,24924
2841,51125,"Nelson County, Virginia",38364,26996.0,22230,11419,5476,32888
2842,51127,"New Kent County, Virginia",40293,31741.0,22893,14993,6736,33557
2843,51131,"Northampton County, Virginia",31959,23233.0,16591,10176,4579,27380
2844,51133,"Northumberland County, Virginia",38679,28646.0,22917,13712,7075,31604
2845,51135,"Nottoway County, Virginia",24394,20318.0,15552,10036,5489,18905
2846,51137,"Orange County, Virginia",33313,26447.0,21107,13545,5824,27489
2847,51139,"Page County, Virginia",26321,22969.0,16321,11304,5395,20926
2848,51141,"Patrick County, Virginia",27939,18396.0,15574,10411,5561,22378
2849,51143,"Pittsylvania County, Virginia",26587,20652.0,16991,11196,5643,20944
2850,51145,"Powhatan County, Virginia",39850,25851.0,24104,15683,5836,34014
2851,51147,"Prince Edward County, Virginia",21051,18192.0,14510,9031,4797,16254
2852,51149,"Prince George County, Virginia",31193,25769.0,20196,12714,5715,25478
2853,51153,"Prince William County, Virginia",42298,35737.0,25641,17833,8213,34085
2854,51155,"Pulaski County, Virginia",28067,20976.0,18973,11074,5822,22245
2855,51157,"Rappahannock County, Virginia",46731,37149.0,23863,17260,6226,40505
2856,51159,"Richmond County, Virginia",24400,19965.0,16675,11036,5779,18621
2857,51161,"Roanoke County, Virginia",37859,31046.0,24637,16627,8088,29771
2858,51163,"Rockbridge County, Virginia",33177,23753.0,18356,11287,5531,27646
2859,51165,"Rockingham County, Virginia",33276,25274.0,18795,12647,6155,27121
2860,51167,"Russell County, Virginia",22030,17909.0,14863,8753,5338,16692
2861,51169,"Scott County, Virginia",23702,18667.0,15073,9100,4649,19053
2862,51171,"Shenandoah County, Virginia",40163,24502.0,19755,12686,5849,34314
2863,51173,"Smyth County, Virginia",23016,19906.0,16105,9613,5271,17745
2864,51175,"Southampton County, Virginia",27232,21201.0,16930,10948,5102,22130
2865,51177,"Spotsylvania County, Virginia",38731,31012.0,22536,15192,6708,32023
2866,51179,"Stafford County, Virginia",43401,34691.0,24762,15917,7321,36080
2867,51181,"Surry County, Virginia",31136,23835.0,16682,11495,5515,25621
2868,51183,"Sussex County, Virginia",24391,16735.0,14670,9856,5176,19215
2869,51185,"Tazewell County, Virginia",25648,19016.0,15282,9995,5786,19862
2870,51187,"Warren County, Virginia",32660,29098.0,19841,13580,6326,26334
2871,51191,"Washington County, Virginia",28987,23488.0,18350,11057,5743,23244
2872,51193,"Westmoreland County, Virginia",33754,27501.0,19473,12268,5851,27903
2873,51195,"Wise County, Virginia",21508,17944.0,14271,9392,5725,15783
2874,51197,"Wythe County, Virginia",31645,20589.0,17639,10404,5579,26066
2875,51199,"York County, Virginia",41994,35823.0,24560,15742,7260,34734
2876,51510,"Alexandria City, Virginia",64835,54345.0,37645,25509,12177,52658
2877,51520,"Bristol City, Virginia",25979,19700.0,17311,10290,6212,19767
2878,51530,"Buena Vista City, Virginia",30647,19030.0,16377,10241,5315,25332
2879,51540,"Charlottesville City, Virginia",39712,24578.0,16973,12928,6935,32777
2880,51550,"Chesapeake City, Virginia",37420,29306.0,20949,13817,6646,30774
2881,51570,"Colonial Heights City, Virginia",32629,26115.0,23659,15639,7981,24648
2882,51580,"Covington City, Virginia",25287,20781.0,16758,10814,6021,19266
2883,51590,"Danville City, Virginia",22876,18840.0,17151,11344,6508,16368
2884,51595,"Emporia City, Virginia",19612,19245.0,15377,10478,5712,13900
2885,51600,"Fairfax City, Virginia",53488,44008.0,31247,21929,10423,43065
2886,51610,"Falls Church City, Virginia",73288,55389.0,41051,26709,12885,60403
2887,51620,"Franklin City, Virginia",25900,19453.0,18573,11212,5992,19908
2888,51630,"Fredericksburg City, Virginia",36785,27870.0,21527,13825,7089,29696
2889,51640,"Galax City, Virginia",24521,19609.0,17447,10490,6624,17897
2890,51650,"Hampton City, Virginia",30596,24051.0,19774,13099,6786,23810
2891,51660,"Harrisonburg City, Virginia",23580,16750.0,14898,11607,5925,17655
2892,51670,"Hopewell City, Virginia",23173,19148.0,16338,11897,6478,16695
2893,51678,"Lexington City, Virginia",20638,17022.0,16497,10077,5574,15064
2894,51680,"Lynchburg City, Virginia",23683,21586.0,18263,12657,6896,16787
2895,51683,"Manassas City, Virginia",34198,28941.0,24453,18554,8550,25648
2896,51685,"Manassas Park City, Virginia",35618,27335.0,21048,13428,6081,29537
2897,51690,"Martinsville City, Virginia",22855,19766.0,17251,13742,6789,16066
2898,51700,"Newport News City, Virginia",33670,24249.0,17843,12711,6856,26814
2899,51710,"Norfolk City, Virginia",30706,23773.0,17372,11643,6113,24593
2900,51720,"Norton City, Virginia",24808,24145.0,16024,9214,6250,18558
2901,51730,"Petersburg City, Virginia",24789,19142.0,15989,10547,6358,18431
2902,51735,"Poquoson City, Virginia",42260,36840.0,25336,16930,7870,34390
2903,51740,"Portsmouth City, Virginia",27276,22302.0,16507,11158,6104,21172
2904,51750,"Radford City, Virginia",22637,16496.0,14289,9704,5878,16759
2905,51760,"Richmond City, Virginia",35682,26034.0,20337,13993,7073,28609
2906,51770,"Roanoke City, Virginia",29585,22530.0,18468,12513,6816,22769
2907,51775,"Salem City, Virginia",34039,27081.0,20091,14467,7590,26449
2908,51790,"Staunton City, Virginia",30746,24077.0,19161,12912,7172,23574
2909,51800,"Suffolk City, Virginia",38613,28441.0,18836,11831,6023,32590
2910,51810,"Virginia Beach City, Virginia",39788,30873.0,22365,15242,7704,32084
2911,51820,"Waynesboro City, Virginia",28287,23190.0,17932,13469,7578,20709
2912,51830,"Williamsburg City, Virginia",32878,22851.0,18483,11822,6411,26467
2913,51840,"Winchester City, Virginia",31719,26341.0,20500,14214,7358,24361
2914,53001,"Adams County, Washington",20592,16689.0,13534,10083,6593,13999
2915,53003,"Asotin County, Washington",30397,23731.0,17748,11379,6859,23538
2916,53005,"Benton County, Washington",34287,27161.0,21301,14027,8763,25524
2917,53007,"Chelan County, Washington",32249,24378.0,19273,12533,7532,24717
2918,53009,"Clallam County, Washington",31601,24449.0,19517,12798,7665,23936
2919,53011,"Clark County, Washington",37009,27828.0,21448,13993,7515,29494
2920,53013,"Columbia County, Washington",38606,25810.0,17374,11108,6347,32259
2921,53015,"Cowlitz County, Washington",30170,22948.0,18583,12638,7608,22562
2922,53017,"Douglas County, Washington",32709,22359.0,17148,12071,6789,25920
2923,53019,"Ferry County, Washington",26983,18021.0,15019,9860,5583,21400
2924,53021,"Franklin County, Washington",25875,18660.0,15459,10407,7069,18806
2925,53023,"Garfield County, Washington",28933,22825.0,16992,12209,7048,21885
2926,53025,"Grant County, Washington",25333,19718.0,15037,10376,6136,19197
2927,53027,"Grays Harbor County, Washington",27277,21656.0,16799,11787,7446,19831
2928,53029,"Island County, Washington",38769,29079.0,21472,13940,7108,31661
2929,53031,"Jefferson County, Washington",38176,28528.0,22211,13551,7749,30427
2930,53033,"King County, Washington",55374,38211.0,29521,18587,9582,45792
2931,53035,"Kitsap County, Washington",39993,29755.0,22317,14311,7814,32179
2932,53037,"Kittitas County, Washington",32120,23467.0,18928,10781,6343,25777
2933,53039,"Klickitat County, Washington",31021,21553.0,16502,10776,6766,24255
2934,53041,"Lewis County, Washington",27941,21695.0,17082,11205,6675,21266
2935,53043,"Lincoln County, Washington",31711,24757.0,17888,11977,7712,23999
2936,53045,"Mason County, Washington",30112,22530.0,18056,12050,7113,22999
2937,53047,"Okanogan County, Washington",25216,20093.0,14900,10346,6283,18933
2938,53049,"Pacific County, Washington",28339,23326.0,17322,10952,7272,21067
2939,53051,"Pend Oreille County, Washington",30326,22546.0,15731,9556,5310,25016
2940,53053,"Pierce County, Washington",36548,27446.0,20948,13439,7409,29139
2941,53055,"San Juan County, Washington",49148,35487.0,30603,21013,8606,40542
2942,53057,"Skagit County, Washington",35172,26925.0,21256,13804,7466,27706
2943,53059,"Skamania County, Washington",34759,24140.0,18002,11621,7907,26852
2944,53061,"Snohomish County, Washington",41126,30635.0,23417,15769,8243,32883
2945,53063,"Spokane County, Washington",32766,25127.0,19233,12804,7180,25586
2946,53065,"Stevens County, Washington",28030,21773.0,15895,10584,5894,22136
2947,53067,"Thurston County, Washington",36256,29707.0,22415,13901,7775,28481
2948,53069,"Wahkiakum County, Washington",28821,23115.0,19063,12332,8176,20645
2949,53071,"Walla Walla County, Washington",30306,23027.0,16509,11508,6908,23398
2950,53073,"Whatcom County, Washington",33241,25407.0,20025,13753,7270,25971
2951,53075,"Whitman County, Washington",24396,19506.0,15298,10653,6228,18168
2952,53077,"Yakima County, Washington",24305,19325.0,15606,10735,6555,17750
2953,54001,"Barbour County, West Virginia",22440,17304.0,12440,8036,4860,17580
2954,54003,"Berkeley County, West Virginia",31415,25460.0,17982,11832,6376,25039
2955,54005,"Boone County, West Virginia",23078,20457.0,14453,9189,5887,17191
2956,54007,"Braxton County, West Virginia",22409,17469.0,13349,8249,4527,17882
2957,54009,"Brooke County, West Virginia",26694,22377.0,17131,11656,7031,19663
2958,54011,"Cabell County, West Virginia",26118,21907.0,17638,12068,6785,19333
2959,54013,"Calhoun County, West Virginia",23009,17121.0,11491,7223,4554,18455
2960,54015,"Clay County, West Virginia",18545,16205.0,12021,6722,3895,14650
2961,54017,"Doddridge County, West Virginia",27040,14658.0,13507,8297,4434,22606
2962,54019,"Fayette County, West Virginia",23170,17082.0,13809,8653,5295,17875
2963,54021,"Gilmer County, West Virginia",18359,13899.0,12498,7872,4478,13881
2964,54023,"Grant County, West Virginia",23908,19358.0,15696,10394,4834,19074
2965,54025,"Greenbrier County, West Virginia",26330,20044.0,16247,10057,5588,20742
2966,54027,"Hampshire County, West Virginia",25409,17752.0,14851,9996,5125,20284
2967,54029,"Hancock County, West Virginia",27261,23118.0,17724,12464,7929,19332
2968,54031,"Hardy County, West Virginia",27819,16944.0,15859,10096,4847,22972
2969,54033,"Harrison County, West Virginia",29086,21010.0,16810,10281,6193,22893
2970,54035,"Jackson County, West Virginia",27591,20633.0,16205,9832,6347,21244
2971,54037,"Jefferson County, West Virginia",36722,29733.0,20441,13249,6139,30583
2972,54039,"Kanawha County, West Virginia",29981,25439.0,20354,12887,7541,22440
2973,54041,"Lewis County, West Virginia",25225,18240.0,13933,8561,5316,19909
2974,54043,"Lincoln County, West Virginia",22995,16439.0,13073,7224,4484,18511
2975,54045,"Logan County, West Virginia",22991,18614.0,14102,8786,5643,17348
2976,54047,"Mcdowell County, West Virginia",15150,12955.0,10174,6961,4779,10371
2977,54049,"Marion County, West Virginia",27763,20752.0,16246,10328,6239,21524
2978,54051,"Marshall County, West Virginia",27328,21064.0,16472,10946,6526,20802
2979,54053,"Mason County, West Virginia",27819,19609.0,14804,9543,5977,21842
2980,54055,"Mercer County, West Virginia",23341,18431.0,15564,10405,6221,17120
2981,54057,"Mineral County, West Virginia",26363,20805.0,15384,10398,5697,20666
2982,54059,"Mingo County, West Virginia",19400,17629.0,12445,8328,5058,14342
2983,54061,"Monongalia County, West Virginia",33527,23116.0,17106,11772,6459,27068
2984,54063,"Monroe County, West Virginia",23398,18927.0,17435,8959,4767,18631
2985,54065,"Morgan County, West Virginia",29803,20732.0,18109,11420,6242,23561
2986,54067,"Nicholas County, West Virginia",22061,19359.0,15207,8652,5405,16656
2987,54069,"Ohio County, West Virginia",31208,23950.0,17734,12348,7074,24134
2988,54071,"Pendleton County, West Virginia",26301,19401.0,15805,9391,4618,21683
2989,54073,"Pleasants County, West Virginia",34191,18770.0,16920,9958,5871,28320
2990,54075,"Pocahontas County, West Virginia",25811,19763.0,14384,8860,5434,20377
2991,54077,"Preston County, West Virginia",25331,19329.0,13596,9158,5397,19934
2992,54079,"Putnam County, West Virginia",32235,25857.0,20471,11840,6578,25657
2993,54081,"Raleigh County, West Virginia",24608,20457.0,16233,10316,6224,18384
2994,54083,"Randolph County, West Virginia",25414,18472.0,14918,9009,5598,19816
2995,54085,"Ritchie County, West Virginia",25773,18255.0,15175,9117,5019,20754
2996,54087,"Roane County, West Virginia",21401,15103.0,13195,7801,4892,16509
2997,54089,"Summers County, West Virginia",22196,15190.0,12419,8203,4813,17383
2998,54091,"Taylor County, West Virginia",26862,18562.0,13681,8746,5224,21638
2999,54093,"Tucker County, West Virginia",26416,20020.0,16349,8978,5102,21314
3000,54095,"Tyler County, West Virginia",27150,18245.0,15216,9692,5867,21283
3001,54097,"Upshur County, West Virginia",26401,18823.0,13559,8748,5316,21085
3002,54099,"Wayne County, West Virginia",23973,18410.0,14906,9430,5615,18358
3003,54101,"Webster County, West Virginia",19943,17268.0,12284,6793,4087,15856
3004,54103,"Wetzel County, West Virginia",23050,19899.0,16818,10454,6273,16777
3005,54105,"Wirt County, West Virginia",23776,18438.0,14000,8163,4749,19027
3006,54107,"Wood County, West Virginia",27983,22890.0,18073,12011,6805,21178
3007,54109,"Wyoming County, West Virginia",23210,17662.0,14220,8268,5467,17743
3008,55001,"Adams County, Wisconsin",28386,21917.0,17777,10926,5647,22739
3009,55003,"Ashland County, Wisconsin",25464,19730.0,16069,9661,5173,20291
3010,55005,"Barron County, Wisconsin",30135,22666.0,18091,10377,5670,24465
3011,55007,"Bayfield County, Wisconsin",33151,24028.0,16407,9933,5214,27937
3012,55009,"Brown County, Wisconsin",34157,26816.0,21784,13906,7185,26972
3013,55011,"Buffalo County, Wisconsin",30957,22579.0,18123,10947,5799,25158
3014,55013,"Burnett County, Wisconsin",30829,22767.0,17712,9623,5021,25808
3015,55015,"Calumet County, Wisconsin",36873,27567.0,21919,12904,7124,29749
3016,55017,"Chippewa County, Wisconsin",31644,23952.0,18243,11170,5868,25776
3017,55019,"Clark County, Wisconsin",25472,19797.0,15100,9810,5266,20206
3018,55021,"Columbia County, Wisconsin",35547,26993.0,21014,12356,6617,28930
3019,55023,"Crawford County, Wisconsin",28259,21346.0,16833,9661,5610,22649
3020,55025,"Dane County, Wisconsin",41755,32392.0,24985,15542,8075,33680
3021,55027,"Dodge County, Wisconsin",31078,23663.0,19574,12050,6903,24175
3022,55029,"Door County, Wisconsin",39162,29154.0,21356,12458,6942,32220
3023,55031,"Douglas County, Wisconsin",30960,24552.0,17638,10744,6340,24620
3024,55033,"Dunn County, Wisconsin",28988,21624.0,17520,10364,5637,23351
3025,55035,"Eau Claire County, Wisconsin",33039,24826.0,19250,11801,6410,26629
3026,55037,"Florence County, Wisconsin",31961,20283.0,18328,10352,5281,26680
3027,55039,"Fond Du Lac County, Wisconsin",32508,25360.0,20022,12574,6802,25706
3028,55041,"Forest County, Wisconsin",26863,20578.0,16451,8339,4427,22436
3029,55043,"Grant County, Wisconsin",26534,20758.0,16764,10704,5918,20616
3030,55045,"Green County, Wisconsin",34872,26721.0,20795,13006,7307,27565
3031,55047,"Green Lake County, Wisconsin",30396,24973.0,19024,11840,6479,23917
3032,55049,"Iowa County, Wisconsin",36035,25156.0,19497,11339,5974,30061
3033,55051,"Iron County, Wisconsin",29146,21286.0,17371,9280,4796,24350
3034,55053,"Jackson County, Wisconsin",27478,20778.0,17604,10173,5565,21913
3035,55055,"Jefferson County, Wisconsin",33461,24729.0,21236,12770,7000,26461
3036,55057,"Juneau County, Wisconsin",28288,23026.0,17892,10304,5590,22698
3037,55059,"Kenosha County, Wisconsin",33103,26168.0,21207,13265,7756,25347
3038,55061,"Kewaunee County, Wisconsin",31723,24574.0,18456,11299,6426,25297
3039,55063,"La Crosse County, Wisconsin",33609,24917.0,19800,12141,6814,26795
3040,55065,"Lafayette County, Wisconsin",28843,22026.0,16811,10641,5940,22903
3041,55067,"Langlade County, Wisconsin",28948,22025.0,16960,10172,5386,23562
3042,55069,"Lincoln County, Wisconsin",31609,23793.0,17940,11282,6160,25449
3043,55071,"Manitowoc County, Wisconsin",31375,25161.0,20285,12235,6848,24527
3044,55073,"Marathon County, Wisconsin",33608,25893.0,20703,12718,6697,26911
3045,55075,"Marinette County, Wisconsin",29395,22999.0,17492,10420,5788,23607
3046,55077,"Marquette County, Wisconsin",28780,22895.0,16924,10652,5708,23072
3047,55078,"Menominee County, Wisconsin",20570,14794.0,10625,5674,3525,17045
3048,55079,"Milwaukee County, Wisconsin",30159,23740.0,19939,13383,7952,22207
3049,55081,"Monroe County, Wisconsin",29946,23052.0,17056,10744,6148,23798
3050,55083,"Oconto County, Wisconsin",31827,24521.0,19016,10375,5439,26388
3051,55085,"Oneida County, Wisconsin",35811,28085.0,19746,11681,6183,29628
3052,55087,"Outagamie County, Wisconsin",34815,26965.0,21943,13893,7267,27548
3053,55089,"Ozaukee County, Wisconsin",49070,39778.0,31947,19249,9640,39430
3054,55091,"Pepin County, Wisconsin",32275,24233.0,18288,10751,5574,26701
3055,55093,"Pierce County, Wisconsin",34223,26313.0,20172,12203,6315,27908
3056,55095,"Polk County, Wisconsin",31995,24704.0,19129,11291,5795,26200
3057,55097,"Portage County, Wisconsin",32268,24873.0,19854,11730,6249,26019
3058,55099,"Price County, Wisconsin",29812,23125.0,17837,10564,5248,24564
3059,55101,"Racine County, Wisconsin",32566,26321.0,21772,14023,7969,24597
3060,55103,"Richland County, Wisconsin",28103,21301.0,17042,10287,5787,22316
3061,55105,"Rock County, Wisconsin",29924,23926.0,20895,13428,7348,22576
3062,55107,"Rusk County, Wisconsin",27212,20573.0,15563,9127,5039,22173
3063,55109,"St. Croix County, Wisconsin",40285,31377.0,23937,14912,7063,33222
3064,55111,"Sauk County, Wisconsin",32066,25452.0,19695,11697,6584,25482
3065,55113,"Sawyer County, Wisconsin",32851,23527.0,17634,9232,5070,27781
3066,55115,"Shawano County, Wisconsin",29682,22539.0,17991,10586,5800,23882
3067,55117,"Sheboygan County, Wisconsin",32360,24976.0,21509,13425,7387,24973
3068,55119,"Taylor County, Wisconsin",28102,22639.0,17570,10452,5703,22399
3069,55121,"Trempealeau County, Wisconsin",30058,23224.0,17681,10674,5654,24404
3070,55123,"Vernon County, Wisconsin",27192,21618.0,15859,10132,5819,21373
3071,55125,"Vilas County, Wisconsin",34548,27128.0,18361,10866,5797,28751
3072,55127,"Walworth County, Wisconsin",34027,26769.0,21229,13526,7123,26904
3073,55129,"Washburn County, Wisconsin",30217,23221.0,17341,9847,5475,24742
3074,55131,"Washington County, Wisconsin",40407,30580.0,24319,14736,7609,32798
3075,55133,"Waukesha County, Wisconsin",47806,36752.0,29164,18148,9211,38595
3076,55135,"Waupaca County, Wisconsin",33784,23293.0,18664,11455,6207,27577
3077,55137,"Waushara County, Wisconsin",29296,22002.0,18144,10408,5943,23353
3078,55139,"Winnebago County, Wisconsin",33101,26383.0,21706,13696,7322,25779
3079,55141,"Wood County, Wisconsin",32037,24893.0,20203,13130,6854,25183
3080,56001,"Albany County, Wyoming",29644,25622.0,16706,11825,6672,22972
3081,56003,"Big Horn County, Wyoming",25587,24486.0,15086,9717,6050,19537
3082,56005,"Campbell County, Wyoming",33522,31968.0,20063,13596,9245,24277
3083,56007,"Carbon County, Wyoming",30929,26122.0,18375,11592,8227,22702
3084,56009,"Converse County, Wyoming",34834,27656.0,18744,12023,8133,26701
3085,56011,"Crook County, Wyoming",29726,24520.0,17379,10322,6854,22872
3086,56013,"Fremont County, Wyoming",27475,24173.0,16519,9806,7269,20206
3087,56015,"Goshen County, Wyoming",29064,23753.0,15965,10598,6274,22790
3088,56017,"Hot Springs County, Wyoming",30170,25269.0,16858,11940,7001,23169
3089,56019,"Johnson County, Wyoming",36794,26753.0,19030,11563,8023,28771
3090,56021,"Laramie County, Wyoming",36421,27406.0,19634,12932,7743,28678
3091,56023,"Lincoln County, Wyoming",31672,24421.0,17533,10558,6442,25230
3092,56025,"Natrona County, Wyoming",34779,28235.0,18913,12992,9353,25426
3093,56027,"Niobrara County, Wyoming",22597,22885.0,15757,11816,6481,16116
3094,56029,"Park County, Wyoming",34803,26203.0,18020,12147,7214,27589
3095,56031,"Platte County, Wyoming",36793,24185.0,17530,10757,7597,29196
3096,56033,"Sheridan County, Wyoming",34495,26756.0,19407,12457,7785,26710
3097,56035,"Sublette County, Wyoming",49313,31433.0,20056,12567,7059,42254
3098,56037,"Sweetwater County, Wyoming",34282,30961.0,19575,13698,8880,25402
3099,56039,"Teton County, Wyoming",60331,42224.0,38260,17234,9040,51291
3100,56041,"Uinta County, Wyoming",30442,24460.0,16994,12245,7518,22924
3101,56043,"Washakie County, Wyoming",30212,28557.0,17780,11017,7066,23146
3102,56045,"Weston County, Wyoming",26573,28463.0,17366,11263,7357,19216
