,Geo_FIPS,Geo_QName,population_2020,population_2010,population_2000,population_1990,population_1980,pop_changes
0,1001,"Autauga County, Alabama",55639,53155,43671,34222,32259,23380
1,1003,"Baldwin County, Alabama",218289,175791,140415,98280,78556,139733
2,1005,"Barbour County, Alabama",25026,27699,29038,25417,24756,270
3,1007,"Bibb County, Alabama",22374,22610,20826,16576,15723,6651
4,1009,"Blount County, Alabama",57755,56692,51024,39248,36459,21296
5,1011,"Bullock County, Alabama",10173,10923,11714,11042,10596,-423
6,1013,"Butler County, Alabama",19726,20895,21399,21892,21680,-1954
7,1015,"Calhoun County, Alabama",114324,117149,112249,116034,119761,-5437
8,1017,"Chambers County, Alabama",33427,34579,36583,36876,39191,-5764
9,1019,"Cherokee County, Alabama",26035,25700,23988,19543,18760,7275
10,1021,"Chilton County, Alabama",44147,43121,39593,32458,30612,13535
11,1023,"Choctaw County, Alabama",12755,14111,15922,16018,16839,-4084
12,1025,"Clarke County, Alabama",23866,26255,27867,27240,27702,-3836
13,1027,"Clay County, Alabama",13285,14040,14254,13252,13703,-418
14,1029,"Cleburne County, Alabama",14952,14823,14123,12730,12595,2357
15,1031,"Coffee County, Alabama",52238,48349,43615,40240,38533,13705
16,1033,"Colbert County, Alabama",54957,54446,54984,51666,54519,438
17,1035,"Conecuh County, Alabama",12219,13382,14089,14054,15884,-3665
18,1037,"Coosa County, Alabama",10696,11470,12202,11063,11377,-681
19,1039,"Covington County, Alabama",37096,37608,37631,36478,36850,246
20,1041,"Crenshaw County, Alabama",13826,13928,13665,13635,14110,-284
21,1043,"Cullman County, Alabama",83345,79941,77483,67613,61642,21703
22,1045,"Dale County, Alabama",49293,49730,49129,49633,47821,1472
23,1047,"Dallas County, Alabama",38184,44066,46365,48130,53981,-15797
24,1049,"De Kalb County, Alabama",71430,70038,64452,54651,53658,17772
25,1051,"Elmore County, Alabama",81526,77650,65874,49210,43390,38136
26,1053,"Escambia County, Alabama",36775,37996,38440,35518,38440,-1665
27,1055,"Etowah County, Alabama",102721,104066,103459,99840,103057,-336
28,1057,"Fayette County, Alabama",16406,17472,18495,17962,18809,-2403
29,1059,"Franklin County, Alabama",31587,31383,31223,27814,28350,3237
30,1061,"Geneva County, Alabama",26383,26541,25764,23647,24253,2130
31,1063,"Greene County, Alabama",8221,9255,9974,10153,11021,-2800
32,1065,"Hale County, Alabama",14754,16168,17185,15498,15604,-850
33,1067,"Henry County, Alabama",17123,17148,16310,15374,15302,1821
34,1069,"Houston County, Alabama",105319,99029,88787,81331,74632,30687
35,1071,"Jackson County, Alabama",51765,53386,53926,47796,51407,358
36,1073,"Jefferson County, Alabama",658615,656912,662047,651525,671324,-12709
37,1075,"Lamar County, Alabama",13854,14743,15904,15715,16453,-2599
38,1077,"Lauderdale County, Alabama",92870,91762,87966,79661,80546,12324
39,1079,"Lawrence County, Alabama",32969,34235,34803,31513,30170,2799
40,1081,"Lee County, Alabama",163461,135010,115092,87146,76283,87178
41,1083,"Limestone County, Alabama",96921,78614,65676,54135,46005,50916
42,1085,"Lowndes County, Alabama",9936,11731,13473,12658,13253,-3317
43,1087,"Macon County, Alabama",18437,21699,24105,24928,26829,-8392
44,1089,"Madison County, Alabama",367686,323080,276700,238912,196966,170720
45,1091,"Marengo County, Alabama",19138,21296,22539,23084,25047,-5909
46,1093,"Marion County, Alabama",29818,30792,31214,29830,30041,-223
47,1095,"Marshall County, Alabama",96137,90867,82231,70832,65622,30515
48,1097,"Mobile County, Alabama",413977,408620,399843,378643,364980,48997
49,1099,"Monroe County, Alabama",21006,23329,24324,23968,22651,-1645
50,1101,"Montgomery County, Alabama",226451,228018,223510,209085,197038,29413
51,1103,"Morgan County, Alabama",119352,117632,111064,100043,90231,29121
52,1105,"Perry County, Alabama",9104,10684,11861,12759,15012,-5908
53,1107,"Pickens County, Alabama",20049,19917,20949,20699,21481,-1432
54,1109,"Pike County, Alabama",33274,32147,29605,27595,28050,5224
55,1111,"Randolph County, Alabama",22732,22817,22380,19881,20075,2657
56,1113,"Russell County, Alabama",57938,51663,49756,46860,47356,10582
57,1115,"St. Clair County, Alabama",88929,80658,64742,50009,41205,47724
58,1117,"Shelby County, Alabama",216350,187880,143293,99358,66298,150052
59,1119,"Sumter County, Alabama",12595,13871,14798,16174,16908,-4313
60,1121,"Talladega County, Alabama",80244,82347,80321,74107,73826,6418
61,1123,"Tallapoosa County, Alabama",40450,41534,41475,38826,38676,1774
62,1125,"Tuscaloosa County, Alabama",208854,188331,164875,150522,137541,71313
63,1127,"Walker County, Alabama",63802,67612,70713,67670,68660,-4858
64,1129,"Washington County, Alabama",16336,17556,18097,16694,16821,-485
65,1131,"Wilcox County, Alabama",10552,12012,13183,13568,14755,-4203
66,1133,"Winston County, Alabama",23712,24687,24843,22053,21953,1759
67,4001,"Apache County, Arizona",71714,70312,69423,61591,52108,19606
68,4003,"Cochise County, Arizona",126442,129268,117755,97624,85686,40756
69,4005,"Coconino County, Arizona",142254,131824,116320,96591,75008,67246
70,4007,"Gila County, Arizona",53846,53272,51335,40216,37080,16766
71,4009,"Graham County, Arizona",38304,36030,33489,26554,22862,15442
72,4011,"Greenlee County, Arizona",9465,8318,8547,8008,11406,-1941
73,4013,"Maricopa County, Arizona",4412779,3751410,3072149,2122101,1509052,2903727
74,4015,"Mohave County, Arizona",210998,199177,155032,93497,55865,155133
75,4017,"Navajo County, Arizona",110271,107060,97470,77658,67629,42642
76,4019,"Pima County, Arizona",1038476,964462,843746,666880,531443,507033
77,4021,"Pinal County, Arizona",447559,329297,179727,116379,90918,356641
78,4023,"Santa Cruz County, Arizona",46594,46051,38381,29676,20459,26135
79,4025,"Yavapai County, Arizona",232396,209260,167517,107714,68145,164251
80,4027,"Yuma County, Arizona",211931,190526,160026,106895,90554,121377
81,5001,"Arkansas County, Arkansas",17761,19321,20749,21653,24175,-6414
82,5003,"Ashley County, Arkansas",20000,22126,24209,24319,26538,-6538
83,5005,"Baxter County, Arkansas",41673,41388,38386,31186,27409,14264
84,5007,"Benton County, Arkansas",273510,209911,153406,97499,78115,195395
85,5009,"Boone County, Arkansas",37525,36710,33948,28297,26067,11458
86,5011,"Bradley County, Arkansas",10805,11638,12600,11793,13803,-2998
87,5013,"Calhoun County, Arkansas",5160,5529,5744,5826,6079,-919
88,5015,"Carroll County, Arkansas",28062,26971,25357,18654,16203,11859
89,5017,"Chicot County, Arkansas",10433,12102,14117,15713,17793,-7360
90,5019,"Clark County, Arkansas",22341,23083,23546,21437,23326,-985
91,5021,"Clay County, Arkansas",14710,16297,17609,18107,20616,-5906
92,5023,"Cleburne County, Arkansas",25063,25692,24046,19411,16909,8154
93,5025,"Cleveland County, Arkansas",8063,8769,8571,7781,7868,195
94,5027,"Columbia County, Arkansas",23620,24756,25603,25691,26644,-3024
95,5029,"Conway County, Arkansas",20895,21059,20336,19151,19505,1390
96,5031,"Craighead County, Arkansas",109081,93329,82148,68956,63239,45842
97,5033,"Crawford County, Arkansas",63118,60778,53247,42493,36892,26226
98,5035,"Crittenden County, Arkansas",48381,50673,50866,49939,49499,-1118
99,5037,"Cross County, Arkansas",16576,18144,19526,19225,20434,-3858
100,5039,"Dallas County, Arkansas",7114,8280,9210,9614,10515,-3401
101,5041,"Desha County, Arkansas",11538,13351,15341,16798,19760,-8222
102,5043,"Drew County, Arkansas",18263,18546,18723,17369,17910,353
103,5045,"Faulkner County, Arkansas",124800,108375,86014,60006,46192,78608
104,5047,"Franklin County, Arkansas",17785,18176,17771,14897,14705,3080
105,5049,"Fulton County, Arkansas",12301,12263,11642,10037,9975,2326
106,5051,"Garland County, Arkansas",99043,95290,88068,73397,70531,28512
107,5053,"Grant County, Arkansas",18229,17657,16464,13948,13008,5221
108,5055,"Greene County, Arkansas",45197,41318,37331,31804,30744,14453
109,5057,"Hempstead County, Arkansas",21695,22747,23587,21621,23635,-1940
110,5059,"Hot Spring County, Arkansas",33667,32671,30353,26115,26819,6848
111,5061,"Howard County, Arkansas",13267,13778,14300,13569,13459,-192
112,5063,"Independence County, Arkansas",37585,35994,34233,31192,30147,7438
113,5065,"Izard County, Arkansas",13596,13636,13249,11364,10768,2828
114,5067,"Jackson County, Arkansas",16908,18015,18418,18944,21646,-4738
115,5069,"Jefferson County, Arkansas",68123,78447,84278,85487,90718,-22595
116,5071,"Johnson County, Arkansas",26475,25180,22781,18221,17423,9052
117,5073,"Lafayette County, Arkansas",6728,7764,8559,9643,10213,-3485
118,5075,"Lawrence County, Arkansas",16511,17340,17774,17457,18447,-1936
119,5077,"Lee County, Arkansas",8963,10709,12580,13053,15539,-6576
120,5079,"Lincoln County, Arkansas",13278,14203,14492,13690,13369,-91
121,5081,"Little River County, Arkansas",12345,13145,13628,13966,13952,-1607
122,5083,"Logan County, Arkansas",21619,22580,22486,20557,20144,1475
123,5085,"Lonoke County, Arkansas",73163,65846,52828,39268,34518,38645
124,5087,"Madison County, Arkansas",16393,15507,14243,11618,11373,5020
125,5089,"Marion County, Arkansas",16586,16779,16140,12001,11334,5252
126,5091,"Miller County, Arkansas",43515,43048,40443,38467,37766,5749
127,5093,"Mississippi County, Arkansas",41396,46815,51979,57525,59517,-18121
128,5095,"Monroe County, Arkansas",6879,8492,10254,11333,14052,-7173
129,5097,"Montgomery County, Arkansas",8964,9490,9245,7841,7771,1193
130,5099,"Nevada County, Arkansas",8249,9149,9955,10101,11097,-2848
131,5101,"Newton County, Arkansas",7753,8394,8608,7666,7756,-3
132,5103,"Ouachita County, Arkansas",23597,26293,28790,30574,30541,-6944
133,5105,"Perry County, Arkansas",10342,10435,10209,7969,7266,3076
134,5107,"Phillips County, Arkansas",18151,22412,26445,28838,34772,-16621
135,5109,"Pike County, Arkansas",10714,11286,11303,10086,10373,341
136,5111,"Poinsett County, Arkansas",23747,24703,25614,24664,27032,-3285
137,5113,"Polk County, Arkansas",19999,20490,20229,17347,17007,2992
138,5115,"Pope County, Arkansas",63926,60460,54469,45883,39021,24905
139,5117,"Prairie County, Arkansas",8138,8839,9539,9518,10140,-2002
140,5119,"Pulaski County, Arkansas",393078,377060,361474,349660,340613,52465
141,5121,"Randolph County, Arkansas",17934,18049,18195,16558,16834,1100
142,5123,"St. Francis County, Arkansas",25477,28302,29329,28497,30858,-5381
143,5125,"Saline County, Arkansas",120990,102439,83529,64183,53161,67829
144,5127,"Scott County, Arkansas",10269,11226,10996,10205,9685,584
145,5129,"Searcy County, Arkansas",7898,8227,8261,7841,8847,-949
146,5131,"Sebastian County, Arkansas",127670,123847,115071,99590,95172,32498
147,5133,"Sevier County, Arkansas",16947,16636,15757,13637,14060,2887
148,5135,"Sharp County, Arkansas",17217,17432,17119,14109,14607,2610
149,5137,"Stone County, Arkansas",12582,12321,11499,9775,9022,3560
150,5139,"Union County, Arkansas",39089,42180,45629,46719,48573,-9484
151,5141,"Van Buren County, Arkansas",16578,17237,16192,14008,13357,3221
152,5143,"Washington County, Arkansas",236198,197192,157715,113409,100494,135704
153,5145,"White County, Arkansas",78725,74957,67165,54676,50835,27890
154,5147,"Woodruff County, Arkansas",6477,7505,8741,9520,11222,-4745
155,5149,"Yell County, Arkansas",21425,21895,21139,17759,17026,4399
156,6001,"Alameda County, California",1661584,1477980,1443741,1279182,1105379,556205
157,6003,"Alpine County, California",1159,1176,1208,1113,1097,62
158,6005,"Amador County, California",39023,38327,35100,30039,19314,19709
159,6007,"Butte County, California",223344,218635,203171,182120,143851,79493
160,6009,"Calaveras County, California",45828,45994,40554,31998,20710,25118
161,6011,"Colusa County, California",21491,21165,18804,16275,12791,8700
162,6013,"Contra Costa County, California",1147788,1024809,948816,803732,656380,491408
163,6015,"Del Norte County, California",27692,28471,27507,23460,18217,9475
164,6017,"El Dorado County, California",190345,179053,156299,125995,85812,104533
165,6019,"Fresno County, California",990204,908830,799407,667490,514621,475583
166,6021,"Glenn County, California",28060,27935,26453,24798,21350,6710
167,6023,"Humboldt County, California",136101,133058,126518,119118,108514,27587
168,6025,"Imperial County, California",180580,168052,142361,109303,92110,88470
169,6027,"Inyo County, California",17930,18434,17945,18281,17895,35
170,6029,"Kern County, California",892458,815693,661645,543477,403089,489369
171,6031,"Kings County, California",151090,151122,129461,101469,73738,77352
172,6033,"Lake County, California",64276,64371,58309,50631,36366,27910
173,6035,"Lassen County, California",30600,35081,33828,27598,21661,8939
174,6037,"Los Angeles County, California",10040682,9758256,9519338,8863164,7477503,2563179
175,6039,"Madera County, California",155925,147738,123109,88090,63116,92809
176,6041,"Marin County, California",259441,248601,247289,230096,222568,36873
177,6043,"Mariposa County, California",17319,18290,17130,14302,11108,6211
178,6045,"Mendocino County, California",87110,87487,86265,80345,66738,20372
179,6047,"Merced County, California",273661,250699,210554,178403,134560,139101
180,6049,"Modoc County, California",8853,9605,9449,9678,8610,243
181,6051,"Mono County, California",14395,13905,12853,9956,8577,5818
182,6053,"Monterey County, California",432977,407435,401762,355660,290444,142533
183,6055,"Napa County, California",138572,134051,124279,110765,99199,39373
184,6057,"Nevada County, California",99417,98186,92033,78510,51645,47772
185,6059,"Orange County, California",3170345,2965525,2846289,2410556,1932709,1237636
186,6061,"Placer County, California",391799,336477,248399,172796,117247,274552
187,6063,"Plumas County, California",18844,20392,20824,19739,17340,1504
188,6065,"Riverside County, California",2437864,2109464,1545387,1170413,663166,1774698
189,6067,"Sacramento County, California",1537948,1395144,1223499,1041219,783381,754567
190,6069,"San Benito County, California",61547,54492,53234,36697,25005,36542
191,6071,"San Bernardino County, California",2162532,2005287,1709434,1418380,895016,1267516
192,6073,"San Diego County, California",3323970,3022468,2813833,2498016,1861846,1462124
193,6075,"San Francisco County, California",874784,789172,776733,723959,678974,195810
194,6077,"San Joaquin County, California",751615,673613,563598,480628,347342,404273
195,6079,"San Luis Obispo County, California",282517,265577,246681,217162,155435,127082
196,6081,"San Mateo County, California",765623,704327,707161,649623,587329,178294
197,6083,"Santa Barbara County, California",444895,416051,399347,369608,298694,146201
198,6085,"Santa Clara County, California",1924379,1739396,1682585,1497577,1295071,629308
199,6087,"Santa Cruz County, California",273170,256901,255602,229734,188141,85029
200,6089,"Shasta County, California",179267,176906,163256,147036,115715,63552
201,6091,"Sierra County, California",2898,3366,3555,3318,3073,-175
202,6093,"Siskiyou County, California",43516,44690,44301,43531,39732,3784
203,6095,"Solano County, California",444538,410042,394542,340421,235203,209335
204,6097,"Sonoma County, California",496801,474047,458614,388222,299681,197120
205,6099,"Stanislaus County, California",546235,509682,446997,370522,265900,280335
206,6101,"Sutter County, California",96315,93420,78930,64415,52246,44069
207,6103,"Tehama County, California",64176,62575,56039,49625,38888,25288
208,6105,"Trinity County, California",12541,13701,13022,13063,11858,683
209,6107,"Tulare County, California",463955,429404,368021,311921,245738,218217
210,6109,"Tuolumne County, California",54147,56074,54501,48456,33928,20219
211,6111,"Ventura County, California",845599,809080,753197,669016,529174,316425
212,6113,"Yolo County, California",218774,196418,168660,141092,113374,105400
213,6115,"Yuba County, California",77524,71160,60219,58228,49733,27791
214,8001,"Adams County, Colorado",509844,425330,363857,265038,245944,263900
215,8003,"Alamosa County, Colorado",16153,15293,14966,13617,11799,4354
216,8005,"Arapahoe County, Colorado",649980,552860,487967,391511,293621,356359
217,8007,"Archuleta County, Colorado",13588,12136,9898,5345,3664,9924
218,8009,"Baca County, Colorado",3570,3833,4517,4556,5419,-1849
219,8011,"Bent County, Colorado",5677,6125,5998,5048,5945,-268
220,8013,"Boulder County, Colorado",324682,290177,291288,225339,189625,135057
221,8015,"Chaffee County, Colorado",19977,17540,16242,12684,13227,6750
222,8017,"Cheyenne County, Colorado",1999,2194,2231,2397,2153,-154
223,8019,"Clear Creek County, Colorado",9533,9088,9322,7619,7308,2225
224,8021,"Conejos County, Colorado",8130,8220,8400,7453,7794,336
225,8023,"Costilla County, Colorado",3810,3536,3663,3190,3071,739
226,8025,"Crowley County, Colorado",5733,5897,5518,3946,2988,2745
227,8027,"Custer County, Colorado",4941,3899,3503,1926,1528,3413
228,8029,"Delta County, Colorado",30758,30533,27834,20980,21225,9533
229,8031,"Denver County, Colorado",715878,578087,554636,467610,492365,223513
230,8033,"Dolores County, Colorado",1896,2027,1844,1504,1658,238
231,8035,"Douglas County, Colorado",344280,273440,175766,60391,25153,319127
232,8037,"Eagle County, Colorado",54960,50793,41659,21928,13320,41640
233,8039,"Elbert County, Colorado",26230,22712,19872,9646,6850,19380
234,8041,"El Paso County, Colorado",710499,599988,516929,397014,309424,401075
235,8043,"Fremont County, Colorado",47725,46941,46145,32273,28676,19049
236,8045,"Garfield County, Colorado",59605,54761,43791,29974,22514,37091
237,8047,"Gilpin County, Colorado",6108,5126,4757,3070,2441,3667
238,8049,"Grand County, Colorado",15536,14526,12442,7966,7475,8061
239,8051,"Gunnison County, Colorado",17119,15136,13956,10273,10689,6430
240,8053,"Hinsdale County, Colorado",781,489,790,467,408,373
241,8055,"Huerfano County, Colorado",6769,6948,7862,6009,6440,329
242,8057,"Jackson County, Colorado",1316,1464,1577,1605,1863,-547
243,8059,"Jefferson County, Colorado",578795,528614,527056,438430,371753,207042
244,8061,"Kiowa County, Colorado",1463,1643,1622,1688,1936,-473
245,8063,"Kit Carson County, Colorado",7246,8156,8011,7140,7599,-353
246,8065,"Lake County, Colorado",7845,7039,7812,6007,8830,-985
247,8067,"La Plata County, Colorado",56138,50149,43941,32284,27424,28714
248,8069,"Larimer County, Colorado",350523,291162,251494,186136,149184,201339
249,8071,"Las Animas County, Colorado",14323,15675,15207,13765,14897,-574
250,8073,"Lincoln County, Colorado",5608,5476,6087,4529,4663,945
251,8075,"Logan County, Colorado",22282,22278,20504,17567,19800,2482
252,8077,"Mesa County, Colorado",152962,142284,116255,93145,81530,71432
253,8079,"Mineral County, Colorado",853,1020,831,558,804,49
254,8081,"Moffat County, Colorado",13150,13519,13184,11357,13133,17
255,8083,"Montezuma County, Colorado",26266,25279,23830,18672,16510,9756
256,8085,"Montrose County, Colorado",42280,40266,33432,24423,24352,17928
257,8087,"Morgan County, Colorado",28617,27911,27171,21939,22513,6104
258,8089,"Otero County, Colorado",18284,18830,20311,20185,22567,-4283
259,8091,"Ouray County, Colorado",4890,4319,3742,2295,1925,2965
260,8093,"Park County, Colorado",18345,16286,14523,7174,5333,13012
261,8095,"Phillips County, Colorado",4343,4394,4480,4189,4542,-199
262,8097,"Pitkin County, Colorado",17980,16389,14872,12661,10338,7642
263,8099,"Prowers County, Colorado",12035,12734,14483,13347,13070,-1035
264,8101,"Pueblo County, Colorado",167412,156244,141472,123051,125972,41440
265,8103,"Rio Blanco County, Colorado",6369,6494,5986,5972,6255,114
266,8105,"Rio Grande County, Colorado",11300,11926,12413,10770,10511,789
267,8107,"Routt County, Colorado",25317,22924,19690,14088,13404,11913
268,8109,"Saguache County, Colorado",6730,6161,5917,4619,3935,2795
269,8111,"San Juan County, Colorado",646,752,558,745,833,-187
270,8113,"San Miguel County, Colorado",8110,7299,6594,3653,3192,4918
271,8115,"Sedgwick County, Colorado",2306,2412,2747,2690,3266,-960
272,8117,"Summit County, Colorado",30735,27105,23548,12881,8848,21887
273,8119,"Teller County, Colorado",24981,22821,20555,12468,8034,16947
274,8121,"Washington County, Colorado",4869,4773,4926,4812,5304,-435
275,8123,"Weld County, Colorado",315389,242860,180936,131821,123438,191951
276,8125,"Yuma County, Colorado",10013,9896,9841,8954,9682,331
277,9001,"Fairfield County, Connecticut",944306,905342,882567,827645,807143,137163
278,9003,"Hartford County, Connecticut",892153,887976,857183,851783,807766,84387
279,9005,"Litchfield County, Connecticut",181143,189916,182193,174092,156769,24374
280,9007,"Middlesex County, Connecticut",162742,164774,155071,143196,129017,33725
281,9009,"New Haven County, Connecticut",855733,856688,824008,804219,761337,94396
282,9011,"New London County, Connecticut",266868,272360,259088,254957,238409,28459
283,9013,"Tolland County, Connecticut",150947,151073,136364,128699,114823,36124
284,9015,"Windham County, Connecticut",116657,117708,109091,102525,92312,24345
285,10001,"Kent County, Delaware",179124,156918,126697,110993,98219,80905
286,10003,"New Castle County, Delaware",558306,533514,500265,441946,398115,160191
287,10005,"Sussex County, Delaware",230249,190846,156638,113229,98004,132245
288,11001,"District Of Columbia, District Of Columbia",701974,584400,572059,606900,638333,63641
289,12001,"Alachua County, Florida",268105,244247,217955,181596,151348,116757
290,12003,"Baker County, Florida",28679,26548,22259,18486,15289,13390
291,12005,"Bay County, Florida",180076,166798,148217,126994,97740,82336
292,12007,"Bradford County, Florida",27723,28750,26088,22515,20023,7700
293,12009,"Brevard County, Florida",594001,540583,476230,398978,272959,321042
294,12011,"Broward County, Florida",1942273,1734139,1623018,1255488,1018200,924073
295,12013,"Calhoun County, Florida",14324,14372,13017,11011,9294,5030
296,12015,"Charlotte County, Florida",185926,159385,141627,110975,58460,127466
297,12017,"Citrus County, Florida",147938,140686,118085,93515,54703,93235
298,12019,"Clay County, Florida",215294,186076,140814,105986,67052,148242
299,12021,"Collier County, Florida",379345,316931,251377,152099,85971,293374
300,12023,"Columbia County, Florida",70898,66964,56513,42613,35399,35499
301,12027,"De Soto County, Florida",37371,34557,32209,23865,19039,18332
302,12029,"Dixie County, Florida",16740,16196,13827,10585,7751,8989
303,12031,"Duval County, Florida",948651,854848,778879,672971,571003,377648
304,12033,"Escambia County, Florida",316691,297940,294410,262798,233794,82897
305,12035,"Flagler County, Florida",112854,91806,49832,28701,10913,101941
306,12037,"Franklin County, Florida",11914,11470,11057,8967,7661,4253
307,12039,"Gadsden County, Florida",45787,46031,45087,41105,41565,4222
308,12041,"Gilchrist County, Florida",18245,16683,14437,9667,5767,12478
309,12043,"Glades County, Florida",13777,12617,10576,7591,5992,7785
310,12045,"Gulf County, Florida",15073,15879,13332,11504,10658,4415
311,12047,"Hamilton County, Florida",14397,14696,13327,10930,8761,5636
312,12049,"Hardee County, Florida",27027,27521,26938,19499,19379,7648
313,12051,"Hendry County, Florida",41472,39030,36210,25773,18599,22873
314,12053,"Hernando County, Florida",190700,170337,130802,101115,44469,146231
315,12055,"Highlands County, Florida",104574,98807,87366,68432,47526,57048
316,12057,"Hillsborough County, Florida",1451358,1200236,998948,834054,646960,804398
317,12059,"Holmes County, Florida",19530,19992,18564,15778,14723,4807
318,12061,"Indian River County, Florida",156964,135518,112947,90208,59896,97068
319,12063,"Jackson County, Florida",47409,49334,46755,41375,39154,8255
320,12065,"Jefferson County, Florida",14278,14583,12902,11296,10703,3575
321,12067,"Lafayette County, Florida",8576,8506,7022,5578,4035,4541
322,12069,"Lake County, Florida",356115,291671,210528,152104,104870,251245
323,12071,"Lee County, Florida",756570,606165,440888,335113,205266,551304
324,12073,"Leon County, Florida",291863,270409,239452,192493,148655,143208
325,12075,"Levy County, Florida",40979,40415,34450,25923,19870,21109
326,12077,"Liberty County, Florida",8333,8230,7021,5569,4260,4073
327,12079,"Madison County, Florida",18557,19300,18733,16569,14894,3663
328,12081,"Manatee County, Florida",393847,318619,264002,211707,148442,245405
329,12083,"Marion County, Florida",360210,326833,258916,194833,122488,237722
330,12085,"Martin County, Florida",160420,144322,126731,100900,64014,96406
331,12087,"Monroe County, Florida",75137,73065,79589,78024,63188,11949
332,12089,"Nassau County, Florida",85762,71099,57663,43941,32894,52868
333,12091,"Okaloosa County, Florida",207430,182076,170498,143776,109920,97510
334,12093,"Okeechobee County, Florida",41611,39883,35910,29627,20264,21347
335,12095,"Orange County, Florida",1373784,1116094,896344,677491,471016,902768
336,12097,"Osceola County, Florida",363666,258531,172493,107728,49287,314379
337,12099,"Palm Beach County, Florida",1482057,1299356,1131184,863518,576863,905194
338,12101,"Pasco County, Florida",539885,456514,344765,281131,193643,346242
339,12103,"Pinellas County, Florida",970985,918263,921482,851659,728531,242454
340,12105,"Polk County, Florida",705735,590116,483924,405382,321652,384083
341,12107,"Putnam County, Florida",73784,74715,70423,65070,50549,23235
342,12109,"St. Johns County, Florida",255410,180624,123135,83829,51303,204107
343,12111,"St. Lucie County, Florida",320914,269659,192695,150171,87182,233732
344,12113,"Santa Rosa County, Florida",179587,147838,117743,81608,55988,123599
345,12115,"Sarasota County, Florida",427766,376200,325957,277776,202251,225515
346,12117,"Seminole County, Florida",466695,417330,365196,287529,179752,286943
347,12119,"Sumter County, Florida",129938,85891,53345,31577,24272,105666
348,12121,"Suwannee County, Florida",44290,40675,34844,26780,22287,22003
349,12123,"Taylor County, Florida",21709,22000,19256,17111,16532,5177
350,12125,"Union County, Florida",15282,15375,13442,10252,10166,5116
351,12127,"Volusia County, Florida",546107,496053,443343,370712,258762,287345
352,12129,"Wakulla County, Florida",32855,29368,22863,14202,10887,21968
353,12131,"Walton County, Florida",71049,53366,40601,27760,21300,49749
354,12133,"Washington County, Florida",25094,24125,20973,16919,14509,10585
355,13001,"Appling County, Georgia",18428,18050,17419,15744,15565,2863
356,13003,"Atkinson County, Georgia",8311,8332,7609,6213,6141,2170
357,13005,"Bacon County, Georgia",11140,10969,10103,9566,9379,1761
358,13007,"Baker County, Georgia",3090,3657,4074,3615,3808,-718
359,13009,"Baldwin County, Georgia",45072,46905,44700,39530,34686,10386
360,13011,"Banks County, Georgia",18900,17840,14422,10308,8702,10198
361,13013,"Barrow County, Georgia",81294,66359,46144,29721,21354,59940
362,13015,"Bartow County, Georgia",106456,97423,76019,55911,40760,65696
363,13017,"Ben Hill County, Georgia",16889,17631,17484,16245,16000,889
364,13019,"Berrien County, Georgia",19206,18708,16235,14153,13525,5681
365,13021,"Bibb County, Georgia",153026,154810,153887,149967,150256,2770
366,13023,"Bleckley County, Georgia",12870,12937,11666,10430,10767,2103
367,13025,"Brantley County, Georgia",18924,17650,14629,11077,8701,10223
368,13027,"Brooks County, Georgia",15548,16338,16450,15398,15255,293
369,13029,"Bryan County, Georgia",38321,29039,23417,15438,10175,28146
370,13031,"Bulloch County, Georgia",77719,67298,55983,43125,35785,41934
371,13033,"Burke County, Georgia",22567,23083,22243,20579,19349,3218
372,13035,"Butts County, Georgia",24463,23401,19522,15326,13665,10798
373,13037,"Calhoun County, Georgia",6301,6488,6320,5013,5717,584
374,13039,"Camden County, Georgia",53960,49293,43664,30167,13371,40589
375,13043,"Candler County, Georgia",10834,10715,9577,7744,7518,3316
376,13045,"Carroll County, Georgia",118692,109227,87268,71422,56346,62346
377,13047,"Catoosa County, Georgia",67181,62951,53282,42464,36991,30190
378,13049,"Charlton County, Georgia",13032,12310,10282,8496,7343,5689
379,13051,"Chatham County, Georgia",289649,256428,232048,216935,202226,87423
380,13053,"Chattahoochee County, Georgia",10470,11702,14882,16934,21732,-11262
381,13055,"Chattooga County, Georgia",24826,25985,25470,22242,21856,2970
382,13057,"Cherokee County, Georgia",253780,206283,141903,90204,51699,202081
383,13059,"Clarke County, Georgia",126952,115070,101489,87594,74498,52454
384,13061,"Clay County, Georgia",2931,2981,3357,3364,3553,-622
385,13063,"Clayton County, Georgia",287560,260156,236517,182052,150357,137203
386,13065,"Clinch County, Georgia",6648,6841,6878,6160,6660,-12
387,13067,"Cobb County, Georgia",756653,677402,607751,447745,297718,458935
388,13069,"Coffee County, Georgia",43070,41647,37413,29592,26894,16176
389,13071,"Colquitt County, Georgia",45510,44712,42053,36645,35376,10134
390,13073,"Columbia County, Georgia",154257,117858,89288,66031,40118,114139
391,13075,"Cook County, Georgia",17217,16976,15771,13456,13490,3727
392,13077,"Coweta County, Georgia",145839,121528,89215,53853,39268,106571
393,13079,"Crawford County, Georgia",12267,12821,12495,8991,7684,4583
394,13081,"Crisp County, Georgia",22509,23182,21996,20011,19489,3020
395,13083,"Dade County, Georgia",16183,16595,15154,13147,12318,3865
396,13085,"Dawson County, Georgia",25277,21758,15999,9429,4774,20503
397,13087,"Decatur County, Georgia",26595,27920,28240,25511,25495,1100
398,13089,"De Kalb County, Georgia",755287,685371,665865,545837,483024,272263
399,13091,"Dodge County, Georgia",20725,21402,19171,17607,16955,3770
400,13093,"Dooly County, Georgia",13571,14283,11525,9901,10826,2745
401,13095,"Dougherty County, Georgia",88696,94514,96065,96311,100718,-12022
402,13097,"Douglas County, Georgia",145063,127800,92174,71120,54573,90490
403,13099,"Early County, Georgia",10218,11286,12354,11854,13158,-2940
404,13101,"Echols County, Georgia",3944,3973,3754,2334,2297,1647
405,13103,"Effingham County, Georgia",62241,50513,37535,25687,18327,43914
406,13105,"Elbert County, Georgia",19164,20421,20511,18949,18758,406
407,13107,"Emanuel County, Georgia",22525,22348,21837,20546,20795,1730
408,13109,"Evans County, Georgia",10671,10966,10495,8724,8428,2243
409,13111,"Fannin County, Georgia",25797,23337,19798,15992,14748,11049
410,13113,"Fayette County, Georgia",113544,105344,91263,62415,29043,84501
411,13115,"Floyd County, Georgia",97805,95810,90565,81251,79800,18005
412,13117,"Forsyth County, Georgia",236605,163885,98407,44083,27958,208647
413,13119,"Franklin County, Georgia",23015,22121,20285,16650,15185,7830
414,13121,"Fulton County, Georgia",1051550,886982,816006,648951,589904,461646
415,13123,"Gilmer County, Georgia",30986,28076,23456,13368,11110,19876
416,13125,"Glascock County, Georgia",2984,3007,2556,2357,2382,602
417,13127,"Glynn County, Georgia",85008,77632,67568,62496,54981,30027
418,13129,"Gordon County, Georgia",57756,54059,44104,35072,30070,27686
419,13131,"Grady County, Georgia",24693,24738,23659,20279,19845,4848
420,13133,"Greene County, Georgia",17808,15844,14406,11793,11391,6417
421,13135,"Gwinnett County, Georgia",926414,778022,588448,352910,166903,759511
422,13137,"Habersham County, Georgia",45204,42212,35902,27621,25020,20184
423,13139,"Hall County, Georgia",201434,175001,139277,95428,75649,125785
424,13141,"Hancock County, Georgia",8500,9649,10076,8908,9466,-966
425,13143,"Haralson County, Georgia",29608,28574,25690,21966,18422,11186
426,13145,"Harris County, Georgia",34676,30807,23695,17788,15464,19212
427,13147,"Hart County, Georgia",25981,25024,22997,19712,18585,7396
428,13149,"Heard County, Georgia",11785,11720,11012,8628,6520,5265
429,13151,"Henry County, Georgia",229994,193717,119341,58741,36309,193685
430,13153,"Houston County, Georgia",155317,134880,110765,89208,77605,77712
431,13155,"Irwin County, Georgia",9379,9642,9931,8649,8988,391
432,13157,"Jackson County, Georgia",70467,58347,41589,30005,25343,45124
433,13159,"Jasper County, Georgia",14074,13695,11426,8453,7553,6521
434,13161,"Jeff Davis County, Georgia",15063,14558,12684,12032,11473,3590
435,13163,"Jefferson County, Georgia",15489,16919,17266,17408,18403,-2914
436,13165,"Jenkins County, Georgia",8787,8400,8575,8247,8841,-54
437,13167,"Johnson County, Georgia",9717,9967,8560,8329,8660,1057
438,13169,"Jones County, Georgia",28622,28292,23639,20739,16579,12043
439,13171,"Lamar County, Georgia",18834,17837,15912,13038,12215,6619
440,13173,"Lanier County, Georgia",10534,9404,7241,5531,5654,4880
441,13175,"Laurens County, Georgia",47404,48034,44874,39988,36990,10414
442,13177,"Lee County, Georgia",29735,27998,24757,16250,11684,18051
443,13179,"Liberty County, Georgia",62039,63854,61610,52745,37583,24456
444,13181,"Lincoln County, Georgia",7929,8111,8348,7442,6716,1213
445,13183,"Long County, Georgia",19236,13142,10304,6202,4524,14712
446,13185,"Lowndes County, Georgia",116436,104916,92115,75981,67972,48464
447,13187,"Lumpkin County, Georgia",33009,28875,21016,14573,10762,22247
448,13189,"Mcduffie County, Georgia",21404,21719,21231,20119,18546,2858
449,13191,"Mcintosh County, Georgia",14217,13817,10847,8634,8046,6171
450,13193,"Macon County, Georgia",13107,14553,14074,13114,14003,-896
451,13195,"Madison County, Georgia",29624,27798,25730,21050,17747,11877
452,13197,"Marion County, Georgia",8450,8403,7144,5590,5297,3153
453,13199,"Meriwether County, Georgia",21080,22425,22534,22411,21229,-149
454,13201,"Miller County, Georgia",5725,6128,6383,6280,7038,-1313
455,13205,"Mitchell County, Georgia",22072,23697,23932,20275,21114,958
456,13207,"Monroe County, Georgia",27455,25864,21757,17113,14610,12845
457,13209,"Montgomery County, Georgia",9069,9138,8270,7163,7011,2058
458,13211,"Morgan County, Georgia",18832,17741,15457,12883,11572,7260
459,13213,"Murray County, Georgia",39789,39925,36506,26147,19685,20104
460,13215,"Muscogee County, Georgia",195418,187629,186291,179278,170108,25310
461,13217,"Newton County, Georgia",109835,96833,62001,41808,34489,75346
462,13219,"Oconee County, Georgia",39194,31508,26225,17618,12427,26767
463,13221,"Oglethorpe County, Georgia",15040,14556,12635,9763,8929,6111
464,13223,"Paulding County, Georgia",164440,134875,81678,41611,26110,138330
465,13225,"Peach County, Georgia",27502,26883,23668,21189,19151,8351
466,13227,"Pickens County, Georgia",32002,29155,22983,14432,11652,20350
467,13229,"Pierce County, Georgia",19336,18205,15636,13328,11897,7439
468,13231,"Pike County, Georgia",18565,17411,13688,10224,8937,9628
469,13233,"Polk County, Georgia",42251,41095,38127,33815,32386,9865
470,13235,"Pulaski County, Georgia",11185,11632,9588,8108,8950,2235
471,13237,"Putnam County, Georgia",21906,20925,18812,14137,10295,11611
472,13239,"Quitman County, Georgia",2290,2528,2598,2209,2357,-67
473,13241,"Rabun County, Georgia",16859,16266,15050,11648,10466,6393
474,13243,"Randolph County, Georgia",6888,7724,7791,8023,9599,-2711
475,13245,"Richmond County, Georgia",202178,198170,199775,189719,181629,20549
476,13247,"Rockdale County, Georgia",90155,83135,70111,54091,36747,53408
477,13249,"Schley County, Georgia",5215,4755,3766,3588,3433,1782
478,13251,"Screven County, Georgia",13977,14799,15374,13842,14043,-66
479,13253,"Seminole County, Georgia",8218,8797,9369,9010,9057,-839
480,13255,"Spalding County, Georgia",66043,63304,58417,54457,47899,18144
481,13257,"Stephens County, Georgia",25934,25876,25435,23257,21763,4171
482,13259,"Stewart County, Georgia",6446,5831,5252,5654,5896,550
483,13261,"Sumter County, Georgia",29714,32865,33200,30228,29360,354
484,13263,"Talbot County, Georgia",6245,6920,6498,6524,6536,-291
485,13265,"Taliaferro County, Georgia",1596,2041,2077,1915,2032,-436
486,13267,"Tattnall County, Georgia",25392,24263,22305,17722,18134,7258
487,13269,"Taylor County, Georgia",8126,8875,8815,7642,7902,224
488,13271,"Telfair County, Georgia",15871,16052,11794,11000,11445,4426
489,13273,"Terrell County, Georgia",8654,9647,10970,10653,12017,-3363
490,13275,"Thomas County, Georgia",44545,44451,42737,38986,38098,6447
491,13277,"Tift County, Georgia",40590,39823,38407,34998,32862,7728
492,13279,"Toombs County, Georgia",26947,27151,26067,24072,22592,4355
493,13281,"Towns County, Georgia",11815,10430,9319,6754,5638,6177
494,13283,"Treutlen County, Georgia",6787,6835,6854,5994,6087,700
495,13285,"Troup County, Georgia",70095,65652,58779,55536,50003,20092
496,13287,"Turner County, Georgia",7920,9025,9504,8703,9510,-1590
497,13289,"Twiggs County, Georgia",8195,9385,10590,9806,9354,-1159
498,13291,"Union County, Georgia",23999,21083,17289,11993,9390,14609
499,13293,"Upson County, Georgia",26329,27308,27597,26300,25998,331
500,13295,"Walker County, Georgia",69398,67845,61053,58340,56470,12928
501,13297,"Walton County, Georgia",93284,81491,60687,38586,31211,62073
502,13299,"Ware County, Georgia",35745,36006,35483,35471,37180,-1435
503,13301,"Warren County, Georgia",5259,5936,6336,6078,6583,-1324
504,13303,"Washington County, Georgia",20316,21112,21176,19112,18842,1474
505,13305,"Wayne County, Georgia",29959,29705,26565,22356,20750,9209
506,13307,"Webster County, Georgia",2587,2727,2390,2263,2341,246
507,13309,"Wheeler County, Georgia",7897,7093,6179,4903,5155,2742
508,13311,"White County, Georgia",29962,26498,19944,13006,10120,19842
509,13313,"Whitfield County, Georgia",104122,99910,83525,72462,65789,38333
510,13315,"Wilcox County, Georgia",8701,9041,8577,7008,7682,1019
511,13317,"Wilkes County, Georgia",9797,10580,10687,10597,10951,-1154
512,13319,"Wilkinson County, Georgia",8945,9685,10220,10228,10368,-1423
513,13321,"Worth County, Georgia",20346,21712,21967,19745,18064,2282
514,16001,"Ada County, Idaho",469473,380718,300904,205775,173036,296437
515,16003,"Adams County, Idaho",4200,3942,3476,3254,3347,853
516,16005,"Bannock County, Idaho",86742,80701,75565,66026,65421,21321
517,16007,"Bear Lake County, Idaho",6054,6026,6411,6084,6931,-877
518,16009,"Benewah County, Idaho",9231,9302,9171,7937,8292,939
519,16011,"Bingham County, Idaho",46246,44496,41735,37583,36489,9757
520,16013,"Blaine County, Idaho",22729,21329,18991,13552,9841,12888
521,16015,"Boise County, Idaho",7625,7122,6670,3509,2999,4626
522,16017,"Bonner County, Idaho",44688,40711,36835,26622,24163,20525
523,16019,"Bonneville County, Idaho",116970,100213,82522,72207,65980,50990
524,16021,"Boundary County, Idaho",12156,10792,9871,8332,7289,4867
525,16023,"Butte County, Idaho",2603,2842,2899,2918,3342,-739
526,16025,"Camas County, Idaho",1069,1216,991,727,818,251
527,16027,"Canyon County, Idaho",223890,182723,131441,90076,83756,140134
528,16029,"Caribou County, Idaho",7028,6900,7304,6963,8695,-1667
529,16031,"Cassia County, Idaho",23847,22109,21416,19532,19427,4420
530,16033,"Clark County, Idaho",885,857,1022,762,798,87
531,16035,"Clearwater County, Idaho",8735,8766,8930,8505,10390,-1655
532,16037,"Custer County, Idaho",4193,4277,4342,4133,3385,808
533,16039,"Elmore County, Idaho",27043,26669,29130,21205,21565,5478
534,16041,"Franklin County, Idaho",13736,12497,11329,9232,8895,4841
535,16043,"Fremont County, Idaho",13111,13062,11819,10937,10813,2298
536,16045,"Gem County, Idaho",17771,16778,15181,11844,11972,5799
537,16047,"Gooding County, Idaho",15280,15140,14155,11633,11874,3406
538,16049,"Idaho County, Idaho",16511,15947,15511,13783,14769,1742
539,16051,"Jefferson County, Idaho",29238,24523,19155,16543,15304,13934
540,16053,"Jerome County, Idaho",24074,21282,18342,15138,14840,9234
541,16055,"Kootenai County, Idaho",161676,134851,108685,69795,59770,101906
542,16057,"Latah County, Idaho",40052,36645,34935,30617,28749,11303
543,16059,"Lemhi County, Idaho",7929,7861,7806,6899,7460,469
544,16061,"Lewis County, Idaho",3850,3761,3747,3516,4118,-268
545,16063,"Lincoln County, Idaho",5342,5021,4044,3308,3436,1906
546,16065,"Madison County, Idaho",39725,36413,27467,23674,19480,20245
547,16067,"Minidoka County, Idaho",20817,19524,20174,19361,19718,1099
548,16069,"Nez Perce County, Idaho",40468,38886,37410,33754,33220,7248
549,16071,"Oneida County, Idaho",4429,4212,4125,3492,3258,1171
550,16073,"Owyhee County, Idaho",11724,11389,10644,8392,8272,3452
551,16075,"Payette County, Idaho",23705,22451,20578,16434,15722,7983
552,16077,"Power County, Idaho",7635,7633,7538,7086,6844,791
553,16079,"Shoshone County, Idaho",12700,12917,13771,13931,19226,-6526
554,16081,"Teton County, Idaho",11776,9413,5999,3439,2897,8879
555,16083,"Twin Falls County, Idaho",86198,74929,64284,53580,52927,33271
556,16085,"Valley County, Idaho",11085,9846,7651,6109,5604,5481
557,16087,"Washington County, Idaho",10128,10105,9977,8550,8803,1325
558,17001,"Adams County, Illinois",65670,67030,68277,66090,71622,-5952
559,17003,"Alexander County, Illinois",6011,8449,9590,10626,12264,-6253
560,17005,"Bond County, Illinois",16520,17904,17633,14991,16224,296
561,17007,"Boone County, Illinois",53293,53567,41786,30806,28630,24663
562,17009,"Brown County, Illinois",6599,6897,6950,5836,5411,1188
563,17011,"Bureau County, Illinois",32878,35083,35503,35688,39114,-6236
564,17013,"Calhoun County, Illinois",4782,5118,5084,5322,5867,-1085
565,17015,"Carroll County, Illinois",14398,15615,16674,16805,18779,-4381
566,17017,"Cass County, Illinois",12324,13648,13695,13437,15084,-2760
567,17019,"Champaign County, Illinois",210006,197867,179669,173025,168392,41614
568,17021,"Christian County, Illinois",32705,34936,35372,34418,36446,-3741
569,17023,"Clark County, Illinois",15602,16545,17008,15921,16913,-1311
570,17025,"Clay County, Illinois",13217,13927,14560,14460,15283,-2066
571,17027,"Clinton County, Illinois",37549,37395,35535,33944,32617,4932
572,17029,"Coles County, Illinois",51065,53568,53196,51644,52260,-1195
573,17031,"Cook County, Illinois",5169517,5172848,5376741,5105067,5253655,-84138
574,17033,"Crawford County, Illinois",18833,19864,20452,19464,20818,-1985
575,17035,"Cumberland County, Illinois",10787,11073,11253,10670,11062,-275
576,17037,"De Kalb County, Illinois",104588,104026,88969,77932,74624,29964
577,17039,"De Witt County, Illinois",15764,16672,16798,16516,18108,-2344
578,17041,"Douglas County, Illinois",19551,20012,19922,19464,19774,-223
579,17043,"Du Page County, Illinois",926005,911481,904161,781666,658835,267170
580,17045,"Edgar County, Illinois",17272,18776,19704,19595,21725,-4453
581,17047,"Edwards County, Illinois",6431,6707,6971,7440,7961,-1530
582,17049,"Effingham County, Illinois",34151,34232,34264,31704,30944,3207
583,17051,"Fayette County, Illinois",21418,22007,21802,20893,22167,-749
584,17053,"Ford County, Illinois",13155,14113,14241,14275,15265,-2110
585,17055,"Franklin County, Illinois",38688,39528,39018,40319,43201,-4513
586,17057,"Fulton County, Illinois",34654,37205,38250,38080,43687,-9033
587,17059,"Gallatin County, Illinois",4983,5773,6445,6909,7590,-2607
588,17061,"Greene County, Illinois",12988,13983,14761,15317,16661,-3673
589,17063,"Grundy County, Illinois",50798,48744,37535,32337,30582,20216
590,17065,"Hamilton County, Illinois",8151,8453,8621,8499,9172,-1021
591,17067,"Hancock County, Illinois",17820,19227,20121,21373,23877,-6057
592,17069,"Hardin County, Illinois",3890,4402,4800,5189,5383,-1493
593,17071,"Henderson County, Illinois",6737,7462,8213,8096,9114,-2377
594,17073,"Henry County, Illinois",49032,50477,51020,51159,57968,-8936
595,17075,"Iroquois County, Illinois",27437,30068,31334,30787,32976,-5539
596,17077,"Jackson County, Illinois",57517,59864,59612,61067,61522,-4005
597,17079,"Jasper County, Illinois",9547,9752,10117,10609,11318,-1771
598,17081,"Jefferson County, Illinois",37774,39202,40045,37020,36552,1222
599,17083,"Jersey County, Illinois",21776,22932,21668,20539,20538,1238
600,17085,"Jo Daviess County, Illinois",21429,22728,22289,21821,23520,-2091
601,17087,"Johnson County, Illinois",12391,12710,12878,11347,9624,2767
602,17089,"Kane County, Illinois",531756,502628,404119,317471,278405,253351
603,17091,"Kankakee County, Illinois",109924,112100,103833,96255,102926,6998
604,17093,"Kendall County, Illinois",127583,105602,54544,39413,37202,90381
605,17095,"Knox County, Illinois",50052,52932,55836,56393,61607,-11555
606,17097,"Lake County, Illinois",699682,697179,644356,516418,440372,259310
607,17099,"La Salle County, Illinois",108998,113789,111509,106913,112033,-3035
608,17101,"Lawrence County, Illinois",15830,16849,15452,15972,17807,-1977
609,17103,"Lee County, Illinois",34204,36100,36062,34392,36328,-2124
610,17105,"Livingston County, Illinois",35757,39010,39678,39301,41381,-5624
611,17107,"Logan County, Illinois",28818,30440,31183,30798,31802,-2984
612,17109,"Mcdonough County, Illinois",30107,32730,32913,35244,37467,-7360
613,17111,"Mchenry County, Illinois",307291,306050,260077,183241,147897,159394
614,17113,"Mclean County, Illinois",172164,166706,150433,129180,119149,53015
615,17115,"Macon County, Illinois",104688,110719,114706,117206,131375,-26687
616,17117,"Macoupin County, Illinois",45243,47980,49019,47679,49384,-4141
617,17119,"Madison County, Illinois",264403,268005,258941,249238,247691,16712
618,17121,"Marion County, Illinois",37524,39722,41691,41561,43523,-5999
619,17123,"Marshall County, Illinois",11562,12763,13180,12846,14479,-2917
620,17125,"Mason County, Illinois",13486,14921,16038,16269,19492,-6006
621,17127,"Massac County, Illinois",14041,15425,15161,14752,14990,-949
622,17129,"Menard County, Illinois",12261,12702,12486,11164,11700,561
623,17131,"Mercer County, Illinois",15503,16551,16957,17290,19286,-3783
624,17133,"Monroe County, Illinois",34444,32431,27619,22422,20117,14327
625,17135,"Montgomery County, Illinois",28598,30230,30652,30728,31686,-3088
626,17137,"Morgan County, Illinois",34012,35755,36616,36397,37502,-3490
627,17139,"Moultrie County, Illinois",14557,14723,14287,13930,14546,11
628,17141,"Ogle County, Illinois",50793,53578,51032,45957,46338,4455
629,17143,"Peoria County, Illinois",181111,185108,183433,182827,200466,-19355
630,17145,"Perry County, Illinois",21092,22488,23094,21412,21714,-622
631,17147,"Piatt County, Illinois",16412,16708,16365,15548,16581,-169
632,17149,"Pike County, Illinois",15571,16580,17384,17577,18896,-3325
633,17151,"Pope County, Illinois",4177,4426,4413,4373,4404,-227
634,17153,"Pulaski County, Illinois",5414,6262,7348,7523,8840,-3426
635,17155,"Putnam County, Illinois",5720,5982,6086,5730,6085,-365
636,17157,"Randolph County, Illinois",31973,33567,33893,34583,35652,-3679
637,17159,"Richland County, Illinois",15677,16166,16149,16545,17587,-1910
638,17161,"Rock Island County, Illinois",142801,147524,149374,148723,165968,-23167
639,17163,"St. Clair County, Illinois",261186,266727,256082,262852,267531,-6345
640,17165,"Saline County, Illinois",23735,25171,26733,26551,28448,-4713
641,17167,"Sangamon County, Illinois",195963,195288,188951,178386,176089,19874
642,17169,"Schuyler County, Illinois",6897,7527,7189,7498,8365,-1468
643,17171,"Scott County, Illinois",4982,5374,5537,5644,6142,-1160
644,17173,"Shelby County, Illinois",21623,22362,22893,22261,23923,-2300
645,17175,"Stark County, Illinois",5393,6086,6332,6534,7389,-1996
646,17177,"Stephenson County, Illinois",44683,47791,48979,48052,49536,-4853
647,17179,"Tazewell County, Illinois",132524,133863,128485,123692,132078,446
648,17181,"Union County, Illinois",16829,17959,18293,17619,17765,-936
649,17183,"Vermilion County, Illinois",76704,82033,83919,88257,95222,-18518
650,17185,"Wabash County, Illinois",11390,12141,12937,13111,13713,-2323
651,17187,"Warren County, Illinois",16981,17745,18735,19181,21943,-4962
652,17189,"Washington County, Illinois",13967,14841,15148,14965,15472,-1505
653,17191,"Wayne County, Illinois",16309,16846,17151,17241,18059,-1750
654,17193,"White County, Illinois",13712,14800,15371,16522,17864,-4152
655,17195,"Whiteside County, Illinois",55583,58750,60653,60186,65970,-10387
656,17197,"Will County, Illinois",689704,667977,502266,357313,324460,365244
657,17199,"Williamson County, Illinois",66929,65579,61296,57733,56538,10391
658,17201,"Winnebago County, Illinois",283635,293972,278418,252913,250884,32751
659,17203,"Woodford County, Illinois",38503,38226,35469,32653,33320,5183
660,18001,"Adams County, Indiana",35544,34162,33625,31095,29619,5925
661,18003,"Allen County, Indiana",375520,351332,331849,300836,294335,81185
662,18005,"Bartholomew County, Indiana",83280,75855,71435,63657,65088,18192
663,18007,"Benton County, Indiana",8695,8820,9421,9441,10218,-1523
664,18009,"Blackford County, Indiana",11926,12960,14048,14067,15570,-3644
665,18011,"Boone County, Indiana",66875,54796,46107,38147,36446,30429
666,18013,"Brown County, Indiana",15093,15271,14957,14080,12377,2716
667,18015,"Carroll County, Indiana",20137,20135,20165,18809,19722,415
668,18017,"Cass County, Indiana",37727,39058,40930,38413,40936,-3209
669,18019,"Clark County, Indiana",117410,107381,96472,87777,88838,28572
670,18021,"Clay County, Indiana",26231,26983,26556,24705,24862,1369
671,18023,"Clinton County, Indiana",32186,33270,33866,30974,31545,641
672,18025,"Crawford County, Indiana",10582,10825,10743,9914,9820,762
673,18027,"Daviess County, Indiana",33277,31045,29820,27533,27836,5441
674,18029,"Dearborn County, Indiana",49612,49580,46109,38835,34291,15321
675,18031,"Decatur County, Indiana",26587,25584,24555,23645,23841,2746
676,18033,"De Kalb County, Indiana",43193,41968,40285,35324,33606,9587
677,18035,"Delaware County, Indiana",114461,117344,118769,119659,128587,-14126
678,18037,"Dubois County, Indiana",42534,41809,39674,36616,34238,8296
679,18039,"Elkhart County, Indiana",205184,196855,182791,156198,137330,67854
680,18041,"Fayette County, Indiana",23068,24367,25588,26015,28272,-5204
681,18043,"Floyd County, Indiana",77879,73594,70823,64404,61169,16710
682,18045,"Fountain County, Indiana",16456,17329,17954,17808,19033,-2577
683,18047,"Franklin County, Indiana",22750,23194,22151,19580,19612,3138
684,18049,"Fulton County, Indiana",20069,20684,20511,18840,19335,734
685,18051,"Gibson County, Indiana",33711,33386,32500,31913,33156,555
686,18053,"Grant County, Indiana",66055,70176,73403,74169,80934,-14879
687,18055,"Greene County, Indiana",32174,33084,33157,30410,30416,1758
688,18057,"Hamilton County, Indiana",330455,261244,182740,108936,82027,248428
689,18059,"Hancock County, Indiana",76614,68011,55391,45527,43939,32675
690,18061,"Harrison County, Indiana",40164,38616,34325,29890,27276,12888
691,18063,"Hendricks County, Indiana",166806,140028,104093,75717,69804,97002
692,18065,"Henry County, Indiana",48158,48921,48508,48139,53336,-5178
693,18067,"Howard County, Indiana",82486,83326,84964,80827,86896,-4410
694,18069,"Huntington County, Indiana",36351,37321,38075,35427,35596,755
695,18071,"Jackson County, Indiana",44077,41902,41335,37730,36523,7554
696,18073,"Jasper County, Indiana",33433,33055,30043,24960,26138,7295
697,18075,"Jay County, Indiana",20697,21441,21806,21512,23239,-2542
698,18077,"Jefferson County, Indiana",32167,32393,31705,29797,30419,1748
699,18079,"Jennings County, Indiana",27639,28470,27554,23661,22854,4785
700,18081,"Johnson County, Indiana",156148,135994,115209,88109,77240,78908
701,18083,"Knox County, Indiana",36833,38425,39256,39884,41838,-5005
702,18085,"Kosciusko County, Indiana",79156,76982,74057,65294,59555,19601
703,18087,"Lagrange County, Indiana",39537,36996,34909,29477,25550,13987
704,18089,"Lake County, Indiana",485983,494417,484564,475594,522965,-36982
705,18091,"La Porte County, Indiana",110026,110937,110106,107066,108632,1394
706,18093,"Lawrence County, Indiana",45552,46192,45922,42836,42472,3080
707,18095,"Madison County, Indiana",129486,131444,133358,130669,139336,-9850
708,18097,"Marion County, Indiana",957337,890976,860454,797159,765233,192104
709,18099,"Marshall County, Indiana",46336,46976,45128,42182,39155,7181
710,18101,"Martin County, Indiana",10169,10324,10369,10369,11001,-832
711,18103,"Miami County, Indiana",35684,37307,36082,36897,39820,-4136
712,18105,"Monroe County, Indiana",147318,134442,120563,108978,98785,48533
713,18107,"Montgomery County, Indiana",38295,38138,37629,34436,35501,2794
714,18109,"Morgan County, Indiana",70141,68654,66689,55920,51999,18142
715,18111,"Newton County, Indiana",13981,14300,14566,13551,14844,-863
716,18113,"Noble County, Indiana",47640,47513,46275,37877,35443,12197
717,18115,"Ohio County, Indiana",5890,6067,5623,5315,5114,776
718,18117,"Orange County, Indiana",19552,19820,19306,18409,18677,875
719,18119,"Owen County, Indiana",20854,21737,21786,17281,15841,5013
720,18121,"Parke County, Indiana",16912,17394,17241,15410,16372,540
721,18123,"Perry County, Indiana",19091,19316,18899,19107,19346,-255
722,18125,"Pike County, Indiana",12364,12955,12837,12509,13465,-1101
723,18127,"Porter County, Indiana",169482,162026,146798,128932,119816,49666
724,18129,"Posey County, Indiana",25480,26100,27061,25968,26414,-934
725,18131,"Pulaski County, Indiana",12482,13596,13755,12643,13258,-776
726,18133,"Putnam County, Indiana",37419,38048,36019,30315,29163,8256
727,18135,"Randolph County, Indiana",24694,26262,27401,27148,29997,-5303
728,18137,"Ripley County, Indiana",28457,28570,26523,24616,24398,4059
729,18139,"Rush County, Indiana",16632,17568,18261,18129,19604,-2972
730,18141,"St. Joseph County, Indiana",270881,266522,265559,247052,241617,29264
731,18143,"Scott County, Indiana",23785,24109,22960,20991,20422,3363
732,18145,"Shelby County, Indiana",44559,44237,43445,40307,39887,4672
733,18147,"Spencer County, Indiana",20364,20977,20391,19490,19361,1003
734,18149,"Starke County, Indiana",22996,23343,23556,22747,21997,999
735,18151,"Steuben County, Indiana",34591,34092,33214,27446,24694,9897
736,18153,"Sullivan County, Indiana",20647,21520,21751,18993,21107,-460
737,18155,"Switzerland County, Indiana",10727,10393,9065,7738,7153,3574
738,18157,"Tippecanoe County, Indiana",193302,168635,148955,130598,121702,71600
739,18159,"Tipton County, Indiana",15154,16132,16577,16119,16819,-1665
740,18161,"Union County, Indiana",7140,7463,7349,6976,6860,280
741,18163,"Vanderburgh County, Indiana",181548,178298,171922,165058,167515,14033
742,18165,"Vermillion County, Indiana",15485,16412,16788,16773,18229,-2744
743,18167,"Vigo County, Indiana",107305,107151,105848,106107,112385,-5080
744,18169,"Wabash County, Indiana",31198,33225,34960,35069,36640,-5442
745,18171,"Warren County, Indiana",8219,8563,8419,8176,8976,-757
746,18173,"Warrick County, Indiana",62608,58393,52383,44920,41474,21134
747,18175,"Washington County, Indiana",27942,28226,27223,23717,21932,6010
748,18177,"Wayne County, Indiana",66176,69187,71097,71951,76058,-9882
749,18179,"Wells County, Indiana",28010,27744,27600,25948,25401,2609
750,18181,"White County, Indiana",24163,24734,25267,23265,23867,296
751,18183,"Whitley County, Indiana",33899,32991,30707,27651,26215,7684
752,19001,"Adair County, Iowa",7048,7779,8243,8409,9509,-2461
753,19003,"Adams County, Iowa",3633,4127,4482,4866,5731,-2098
754,19005,"Allamakee County, Iowa",13761,14331,14675,13855,15108,-1347
755,19007,"Appanoose County, Iowa",12462,13029,13721,13743,15511,-3049
756,19009,"Audubon County, Iowa",5528,6186,6830,7334,8559,-3031
757,19011,"Benton County, Iowa",25558,26098,25308,22429,23649,1909
758,19013,"Black Hawk County, Iowa",131813,129252,128012,123798,137961,-6148
759,19015,"Boone County, Iowa",26381,26424,26224,25186,26184,197
760,19017,"Bremer County, Iowa",25032,24185,23325,22813,24820,212
761,19019,"Buchanan County, Iowa",21141,21026,21093,20844,22900,-1759
762,19021,"Buena Vista County, Iowa",19950,19980,20411,19965,20774,-824
763,19023,"Butler County, Iowa",14508,14892,15305,15731,17668,-3160
764,19025,"Calhoun County, Iowa",9656,9846,11115,11508,13542,-3886
765,19027,"Carroll County, Iowa",20150,20805,21421,21423,22951,-2801
766,19029,"Cass County, Iowa",12990,13969,14684,15128,16932,-3942
767,19031,"Cedar County, Iowa",18475,18414,18187,17381,18635,-160
768,19033,"Cerro Gordo County, Iowa",42672,44324,46447,46733,48458,-5786
769,19035,"Cherokee County, Iowa",11281,12086,13035,14098,16238,-4957
770,19037,"Chickasaw County, Iowa",11970,12499,13095,13295,15437,-3467
771,19039,"Clarke County, Iowa",9383,9218,9133,8287,8612,771
772,19041,"Clay County, Iowa",16138,16718,17372,17585,19576,-3438
773,19043,"Clayton County, Iowa",17527,18202,18678,19054,21098,-3571
774,19045,"Clinton County, Iowa",46734,49274,50149,51040,57122,-10388
775,19047,"Crawford County, Iowa",16998,16951,16942,16775,18935,-1937
776,19049,"Dallas County, Iowa",90418,61714,40750,29755,29513,60905
777,19051,"Davis County, Iowa",8977,8687,8541,8312,9104,-127
778,19053,"Decatur County, Iowa",7908,8508,8689,8338,9794,-1886
779,19055,"Delaware County, Iowa",17107,17857,18404,18035,18933,-1826
780,19057,"Des Moines County, Iowa",39227,40266,42351,42614,46203,-6976
781,19059,"Dickinson County, Iowa",17260,16665,16424,14909,15629,1631
782,19061,"Dubuque County, Iowa",97193,92547,89143,86403,93745,3448
783,19063,"Emmet County, Iowa",9322,10389,11027,11569,13336,-4014
784,19065,"Fayette County, Iowa",19604,20992,22008,21843,25488,-5884
785,19067,"Floyd County, Iowa",15713,16394,16900,17058,19597,-3884
786,19069,"Franklin County, Iowa",10091,10697,10704,11364,13036,-2945
787,19071,"Fremont County, Iowa",6895,7528,8010,8226,9401,-2506
788,19073,"Greene County, Iowa",8923,9448,10366,10045,12119,-3196
789,19075,"Grundy County, Iowa",12262,12401,12369,12029,14366,-2104
790,19077,"Guthrie County, Iowa",10702,11040,11353,10935,11983,-1281
791,19079,"Hamilton County, Iowa",14905,15874,16438,16071,17862,-2957
792,19081,"Hancock County, Iowa",10709,11505,12100,12638,13833,-3124
793,19083,"Hardin County, Iowa",16924,17685,18812,19094,21776,-4852
794,19085,"Harrison County, Iowa",14043,15073,15666,14730,16348,-2305
795,19087,"Henry County, Iowa",19889,20263,20336,19226,18890,999
796,19089,"Howard County, Iowa",9201,9610,9932,9809,11114,-1913
797,19091,"Humboldt County, Iowa",9518,9905,10381,10756,12246,-2728
798,19093,"Ida County, Iowa",6862,7172,7837,8365,8908,-2046
799,19095,"Iowa County, Iowa",16155,16353,15671,14630,15429,726
800,19097,"Jackson County, Iowa",19348,19942,20296,19950,22503,-3155
801,19099,"Jasper County, Iowa",37032,37050,37213,34795,36425,607
802,19101,"Jefferson County, Iowa",18153,16643,16181,16310,16316,1837
803,19103,"Johnson County, Iowa",150819,126994,111006,96119,81717,69102
804,19105,"Jones County, Iowa",20575,20708,20221,19444,20401,174
805,19107,"Keokuk County, Iowa",10163,10614,11400,11624,12921,-2758
806,19109,"Kossuth County, Iowa",14864,15748,17163,18591,21891,-7027
807,19111,"Lee County, Iowa",33946,35991,38052,38687,43106,-9160
808,19113,"Linn County, Iowa",225601,207765,191701,168767,169775,55826
809,19115,"Louisa County, Iowa",11125,11683,12183,11592,12055,-930
810,19117,"Lucas County, Iowa",8556,9116,9422,9070,10313,-1757
811,19119,"Lyon County, Iowa",11800,11564,11763,11952,12896,-1096
812,19121,"Madison County, Iowa",16148,15488,14019,12483,12597,3551
813,19123,"Mahaska County, Iowa",22351,22382,22335,21522,22867,-516
814,19125,"Marion County, Iowa",33193,33378,32052,30001,29669,3524
815,19127,"Marshall County, Iowa",39804,40131,39311,38276,41652,-1848
816,19129,"Mills County, Iowa",15023,15157,14547,13202,13406,1617
817,19131,"Mitchell County, Iowa",10588,10801,10874,10928,12329,-1741
818,19133,"Monona County, Iowa",8675,9346,10020,10034,11692,-3017
819,19135,"Monroe County, Iowa",7761,7918,8016,8114,9209,-1448
820,19137,"Montgomery County, Iowa",10016,10901,11771,12076,13413,-3397
821,19139,"Muscatine County, Iowa",42703,42501,41722,39907,40436,2267
822,19141,"O'brien County, Iowa",13796,14419,15102,15444,16972,-3176
823,19143,"Osceola County, Iowa",6016,6576,7003,7267,8371,-2355
824,19145,"Page County, Iowa",15205,16095,16976,16870,19063,-3858
825,19147,"Palo Alto County, Iowa",8941,9508,10147,10669,12721,-3780
826,19149,"Plymouth County, Iowa",25141,24933,24849,23388,24743,398
827,19151,"Pocahontas County, Iowa",6725,7509,8662,9525,11369,-4644
828,19153,"Polk County, Iowa",485418,419301,374601,327140,303170,182248
829,19155,"Pottawattamie County, Iowa",93478,91928,87704,82628,86561,6917
830,19157,"Poweshiek County, Iowa",18391,19012,18815,19033,19306,-915
831,19159,"Ringgold County, Iowa",4922,5169,5469,5420,6112,-1190
832,19161,"Sac County, Iowa",9711,10480,11529,12324,14118,-4407
833,19163,"Scott County, Iowa",172938,162184,158668,150979,160022,12916
834,19165,"Shelby County, Iowa",11544,12328,13173,13230,15043,-3499
835,19167,"Sioux County, Iowa",34900,33377,31589,29903,30813,4087
836,19169,"Story County, Iowa",97355,87594,79981,74252,72326,25029
837,19171,"Tama County, Iowa",16962,17952,18103,17419,19533,-2571
838,19173,"Taylor County, Iowa",6160,6402,6958,7114,8353,-2193
839,19175,"Union County, Iowa",12303,12409,12309,12750,13858,-1555
840,19177,"Van Buren County, Iowa",7104,7645,7809,7676,8626,-1522
841,19179,"Wapello County, Iowa",35102,35553,36051,35687,40241,-5139
842,19181,"Warren County, Iowa",50867,45346,40671,36033,34878,15989
843,19183,"Washington County, Iowa",22100,21626,20670,19612,20141,1959
844,19185,"Wayne County, Iowa",6426,6404,6730,7067,8199,-1773
845,19187,"Webster County, Iowa",36348,38286,40235,40342,45953,-9605
846,19189,"Winnebago County, Iowa",10474,10962,11723,12122,13010,-2536
847,19191,"Winneshiek County, Iowa",20090,21031,21310,20847,21876,-1786
848,19193,"Woodbury County, Iowa",102687,101217,103877,98276,100884,1803
849,19195,"Worth County, Iowa",7422,7628,7909,7991,9075,-1653
850,19197,"Wright County, Iowa",12644,13384,14334,14269,16319,-3675
851,20001,"Allen County, Kansas",12503,13473,14385,14638,15654,-3151
852,20003,"Anderson County, Kansas",7877,8084,8110,7803,8749,-872
853,20005,"Atchison County, Kansas",16210,16889,16774,16932,18397,-2187
854,20007,"Barber County, Kansas",4493,4900,5307,5874,6548,-2055
855,20009,"Barton County, Kansas",26209,27499,28205,29382,31343,-5134
856,20011,"Bourbon County, Kansas",14539,15097,15379,14966,15969,-1430
857,20013,"Brown County, Kansas",9575,10019,10724,11128,11955,-2380
858,20015,"Butler County, Kansas",66890,64853,59482,50580,44782,22108
859,20017,"Chase County, Kansas",2604,2834,3030,3021,3309,-705
860,20019,"Chautauqua County, Kansas",3280,3736,4359,4407,5016,-1736
861,20021,"Cherokee County, Kansas",20017,21740,22605,21374,22304,-2287
862,20023,"Cheyenne County, Kansas",2639,2783,3165,3243,3678,-1039
863,20025,"Clark County, Kansas",2006,2231,2390,2418,2599,-593
864,20027,"Clay County, Kansas",8030,8531,8822,9158,9802,-1772
865,20029,"Cloud County, Kansas",8831,9538,10268,11023,12494,-3663
866,20031,"Coffey County, Kansas",8218,8587,8865,8404,9370,-1152
867,20033,"Comanche County, Kansas",1759,1865,1967,2313,2554,-795
868,20035,"Cowley County, Kansas",35090,36140,36291,36915,36824,-1734
869,20037,"Crawford County, Kansas",38874,38985,38242,35568,37916,958
870,20039,"Decatur County, Kansas",2826,3015,3472,4021,4509,-1683
871,20041,"Dickinson County, Kansas",18614,19643,19344,18958,20175,-1561
872,20043,"Doniphan County, Kansas",7616,7957,8249,8134,9268,-1652
873,20045,"Douglas County, Kansas",121304,109052,99962,81798,67640,53664
874,20047,"Edwards County, Kansas",2822,3052,3449,3787,4271,-1449
875,20049,"Elk County, Kansas",2502,2930,3261,3327,3918,-1416
876,20051,"Ellis County, Kansas",28747,28039,27507,26004,26098,2649
877,20053,"Ellsworth County, Kansas",6176,6476,6525,6586,6640,-464
878,20055,"Finney County, Kansas",36451,36139,40523,33070,23825,12626
879,20057,"Ford County, Kansas",33718,32727,32458,27463,24315,9403
880,20059,"Franklin County, Kansas",25643,25841,24784,21994,22062,3581
881,20061,"Geary County, Kansas",33309,30537,27947,30453,29852,3457
882,20063,"Gove County, Kansas",2650,2721,3068,3231,3726,-1076
883,20065,"Graham County, Kansas",2464,2663,2946,3543,3995,-1531
884,20067,"Grant County, Kansas",7324,7744,7909,7159,6977,347
885,20069,"Gray County, Kansas",6020,5870,5904,5396,5138,882
886,20071,"Greeley County, Kansas",1156,1294,1534,1774,1845,-689
887,20073,"Greenwood County, Kansas",6010,6824,7673,7847,8764,-2754
888,20075,"Hamilton County, Kansas",2552,2643,2670,2388,2514,38
889,20077,"Harper County, Kansas",5506,6033,6536,7124,7778,-2272
890,20079,"Harvey County, Kansas",34434,34150,32869,31028,30531,3903
891,20081,"Haskell County, Kansas",3990,4196,4307,3886,3814,176
892,20083,"Hodgeman County, Kansas",1872,1955,2085,2177,2269,-397
893,20085,"Jackson County, Kansas",13249,13360,12657,11525,11644,1605
894,20087,"Jefferson County, Kansas",18974,19059,18426,15905,15207,3767
895,20089,"Jewell County, Kansas",2854,3151,3791,4251,5241,-2387
896,20091,"Johnson County, Kansas",597574,531228,451086,355054,270269,327305
897,20093,"Kearny County, Kansas",3863,3966,4531,4027,3435,428
898,20095,"Kingman County, Kansas",7173,7949,8673,8292,8960,-1787
899,20097,"Kiowa County, Kansas",2483,2671,3278,3660,4046,-1563
900,20099,"Labette County, Kansas",19938,21791,22835,23693,25682,-5744
901,20101,"Lane County, Kansas",1523,1725,2155,2375,2472,-949
902,20103,"Leavenworth County, Kansas",81499,74611,68691,64371,54809,26690
903,20105,"Lincoln County, Kansas",3013,3308,3578,3653,4145,-1132
904,20107,"Linn County, Kansas",9687,9782,9570,8254,8234,1453
905,20109,"Logan County, Kansas",2789,2774,3046,3081,3478,-689
906,20111,"Lyon County, Kansas",33237,34974,35935,34732,35108,-1871
907,20113,"Mcpherson County, Kansas",28557,29178,29554,27268,26855,1702
908,20115,"Marion County, Kansas",11865,12689,13361,12888,13522,-1657
909,20117,"Marshall County, Kansas",9713,10147,10965,11705,12787,-3074
910,20119,"Meade County, Kansas",4120,4523,4631,4247,4788,-668
911,20121,"Miami County, Kansas",33740,32116,28351,23466,21618,12122
912,20123,"Mitchell County, Kansas",6053,6383,6932,7203,8117,-2064
913,20125,"Montgomery County, Kansas",32114,35453,36252,38816,42281,-10167
914,20127,"Morris County, Kansas",5551,5946,6104,6198,6419,-868
915,20129,"Morton County, Kansas",2656,3244,3496,3480,3454,-798
916,20131,"Nemaha County, Kansas",10109,10253,10717,10446,11211,-1102
917,20133,"Neosho County, Kansas",16008,16538,16997,17035,18967,-2959
918,20135,"Ness County, Kansas",2838,3120,3454,4033,4498,-1660
919,20137,"Norton County, Kansas",5416,5692,5953,5947,6689,-1273
920,20139,"Osage County, Kansas",15855,16426,16712,15248,15319,536
921,20141,"Osborne County, Kansas",3494,3906,4452,4867,5959,-2465
922,20143,"Ottawa County, Kansas",5776,6107,6163,5634,5971,-195
923,20145,"Pawnee County, Kansas",6539,6913,7233,7555,8065,-1526
924,20147,"Phillips County, Kansas",5297,5601,6001,6590,7406,-2109
925,20149,"Pottawatomie County, Kansas",24203,20781,18209,16128,14782,9421
926,20151,"Pratt County, Kansas",9324,9670,9647,9702,10275,-951
927,20153,"Rawlins County, Kansas",2490,2594,2966,3404,4105,-1615
928,20155,"Reno County, Kansas",62421,64054,64790,62389,64983,-2562
929,20157,"Republic County, Kansas",4607,5069,5835,6482,7569,-2962
930,20159,"Rice County, Kansas",9532,10128,10761,10610,11900,-2368
931,20161,"Riley County, Kansas",74059,69035,62843,67139,63505,10554
932,20163,"Rooks County, Kansas",4985,5241,5685,6039,7006,-2021
933,20165,"Rush County, Kansas",2953,3290,3551,3842,4516,-1563
934,20167,"Russell County, Kansas",6896,6915,7370,7835,8868,-1972
935,20169,"Saline County, Kansas",54384,54982,53597,49301,48905,5479
936,20171,"Scott County, Kansas",4893,4832,5120,5289,5782,-889
937,20173,"Sedgwick County, Kansas",515416,486123,452869,403662,366531,148885
938,20175,"Seward County, Kansas",21902,22588,22510,18743,17071,4831
939,20177,"Shawnee County, Kansas",177293,175537,169871,160976,154916,22377
940,20179,"Sheridan County, Kansas",2515,2578,2813,3043,3544,-1029
941,20181,"Sherman County, Kansas",5904,6002,6760,6926,7759,-1855
942,20183,"Smith County, Kansas",3594,3934,4536,5078,5947,-2353
943,20185,"Stafford County, Kansas",4125,4433,4789,5365,5694,-1569
944,20187,"Stanton County, Kansas",2030,2197,2406,2333,2339,-309
945,20189,"Stevens County, Kansas",5498,5533,5463,5048,4736,762
946,20191,"Sumner County, Kansas",22928,24257,25946,25841,24928,-2000
947,20193,"Thomas County, Kansas",7748,7757,8180,8258,8451,-703
948,20195,"Trego County, Kansas",2802,2979,3319,3694,4165,-1363
949,20197,"Wabaunsee County, Kansas",6877,7004,6885,6603,6867,10
950,20199,"Wallace County, Kansas",1583,1440,1749,1821,2045,-462
951,20201,"Washington County, Kansas",5474,5851,6483,7073,8543,-3069
952,20203,"Wichita County, Kansas",2112,2244,2531,2758,3041,-929
953,20205,"Wilson County, Kansas",8600,9598,10332,10289,12128,-3528
954,20207,"Woodson County, Kansas",3117,3352,3788,4116,4600,-1483
955,20209,"Wyandotte County, Kansas",165447,155462,157882,161993,172335,-6888
956,21001,"Adair County, Kentucky",19366,18542,17244,15360,15233,4133
957,21003,"Allen County, Kentucky",21065,19688,17800,14628,14128,6937
958,21005,"Anderson County, Kentucky",22580,21080,19111,14571,12567,10013
959,21007,"Ballard County, Kentucky",7914,8225,8286,7902,8798,-884
960,21009,"Barren County, Kentucky",44026,41685,38033,34001,34009,10017
961,21011,"Bath County, Kentucky",12421,11565,11085,9692,10025,2396
962,21013,"Bell County, Kentucky",26426,28793,30060,31506,34330,-7904
963,21015,"Boone County, Kentucky",132368,114723,85991,57589,45842,86526
964,21017,"Bourbon County, Kentucky",19998,19947,19360,19236,19405,593
965,21019,"Boyd County, Kentucky",47361,49330,49752,51150,55513,-8152
966,21021,"Boyle County, Kentucky",30090,28245,27697,25641,25066,5024
967,21023,"Bracken County, Kentucky",8308,8479,8279,7766,7738,570
968,21025,"Breathitt County, Kentucky",12802,14202,16100,15703,17004,-4202
969,21027,"Breckinridge County, Kentucky",20283,19893,18648,16312,16861,3422
970,21029,"Bullitt County, Kentucky",80921,72515,61236,47567,43346,37575
971,21031,"Butler County, Kentucky",12756,12763,13010,11245,11064,1692
972,21033,"Caldwell County, Kentucky",12679,12934,13060,13232,13473,-794
973,21035,"Calloway County, Kentucky",38991,36763,34177,30735,30031,8960
974,21037,"Campbell County, Kentucky",93608,89016,88616,83866,83317,10291
975,21039,"Carlisle County, Kentucky",4738,5126,5351,5238,5487,-749
976,21041,"Carroll County, Kentucky",10691,10703,10155,9292,9270,1421
977,21043,"Carter County, Kentucky",26976,27821,26889,24340,25060,1916
978,21045,"Casey County, Kentucky",15968,15939,15447,14211,14818,1150
979,21047,"Christian County, Kentucky",71470,72678,72265,68941,66878,4592
980,21049,"Clark County, Kentucky",36152,35305,33144,29496,28322,7830
981,21051,"Clay County, Kentucky",20110,22197,24556,21746,22752,-2642
982,21053,"Clinton County, Kentucky",10175,10161,9634,9135,9321,854
983,21055,"Crittenden County, Kentucky",8940,9313,9384,9196,9207,-267
984,21057,"Cumberland County, Kentucky",6660,6931,7147,6784,7289,-629
985,21059,"Daviess County, Kentucky",101001,95398,91545,87189,85949,15052
986,21061,"Edmonson County, Kentucky",12195,12086,11644,10357,9962,2233
987,21063,"Elliott County, Kentucky",7461,7493,6748,6455,6908,553
988,21065,"Estill County, Kentucky",14187,14733,15307,14614,14495,-308
989,21067,"Fayette County, Kentucky",322200,288045,260512,225366,204165,118035
990,21069,"Fleming County, Kentucky",14519,14318,13792,12292,12323,2196
991,21071,"Floyd County, Kentucky",35931,39949,42441,43586,48764,-12833
992,21073,"Franklin County, Kentucky",50744,49067,47687,43781,41830,8914
993,21075,"Fulton County, Kentucky",6064,6858,7752,8271,8971,-2907
994,21077,"Gallatin County, Kentucky",8760,8428,7870,5393,4842,3918
995,21079,"Garrard County, Kentucky",17554,16842,14792,11579,10853,6701
996,21081,"Grant County, Kentucky",25107,24604,22384,15737,13308,11799
997,21083,"Graves County, Kentucky",37125,36958,37028,33550,34049,3076
998,21085,"Grayson County, Kentucky",26313,25540,24053,21050,20854,5459
999,21087,"Green County, Kentucky",11000,11377,11518,10371,11043,-43
1000,21089,"Greenup County, Kentucky",35359,36962,36891,36742,39132,-3773
1001,21091,"Hancock County, Kentucky",8748,8555,8392,7864,7742,1006
1002,21093,"Hardin County, Kentucky",109627,100876,94174,89240,88917,20710
1003,21095,"Harlan County, Kentucky",26307,29688,33202,36574,41889,-15582
1004,21097,"Harrison County, Kentucky",18763,18761,17983,16248,15166,3597
1005,21099,"Hart County, Kentucky",18833,18201,17445,14890,15402,3431
1006,21101,"Henderson County, Kentucky",45550,45943,44829,43044,40849,4701
1007,21103,"Henry County, Kentucky",15999,15474,15060,12823,12740,3259
1008,21105,"Hickman County, Kentucky",4461,4949,5262,5566,6065,-1604
1009,21107,"Hopkins County, Kentucky",45044,46886,46519,46126,46174,-1130
1010,21109,"Jackson County, Kentucky",13368,13560,13495,11955,11996,1372
1011,21111,"Jefferson County, Kentucky",768419,729452,693604,664937,685004,83415
1012,21113,"Jessamine County, Kentucky",53476,47073,39041,30508,26146,27330
1013,21115,"Johnson County, Kentucky",22427,23325,23445,23248,24432,-2005
1014,21117,"Kenton County, Kentucky",166552,158034,151464,142031,137058,29494
1015,21119,"Knott County, Kentucky",15041,16587,17649,17906,17940,-2899
1016,21121,"Knox County, Kentucky",31288,31765,31795,29676,30239,1049
1017,21123,"Larue County, Kentucky",14269,14080,13373,11679,11922,2347
1018,21125,"Laurel County, Kentucky",60631,58155,52715,43438,38982,21649
1019,21127,"Lawrence County, Kentucky",15604,15841,15569,13998,14121,1483
1020,21129,"Lee County, Kentucky",7088,7865,7916,7422,7754,-666
1021,21131,"Leslie County, Kentucky",10081,11470,12401,13642,14882,-4801
1022,21133,"Letcher County, Kentucky",21936,24462,25277,27000,30687,-8751
1023,21135,"Lewis County, Kentucky",13345,13968,14092,13029,14545,-1200
1024,21137,"Lincoln County, Kentucky",24493,24779,23361,20045,19053,5440
1025,21139,"Livingston County, Kentucky",9172,9514,9804,9062,9219,-47
1026,21141,"Logan County, Kentucky",27049,26838,26573,24416,24138,2911
1027,21143,"Lyon County, Kentucky",8226,8367,8080,6624,6490,1736
1028,21145,"Mccracken County, Kentucky",65485,65217,65514,62879,61310,4175
1029,21147,"Mccreary County, Kentucky",17333,18122,17080,15603,15634,1699
1030,21149,"Mclean County, Kentucky",9202,9635,9938,9628,10090,-888
1031,21151,"Madison County, Kentucky",92090,81580,70872,57508,53352,38738
1032,21153,"Magoffin County, Kentucky",12346,13294,13332,13077,13515,-1169
1033,21155,"Marion County, Kentucky",19257,19619,18212,16499,17910,1347
1034,21157,"Marshall County, Kentucky",31225,31386,30125,27205,25637,5588
1035,21159,"Martin County, Kentucky",11421,13138,12578,12526,13925,-2504
1036,21161,"Mason County, Kentucky",17122,17362,16800,16666,17765,-643
1037,21163,"Meade County, Kentucky",28379,28907,26349,24170,22854,5525
1038,21165,"Menifee County, Kentucky",6463,6427,6556,5092,5117,1346
1039,21167,"Mercer County, Kentucky",21690,21272,20817,19148,19011,2679
1040,21169,"Metcalfe County, Kentucky",10062,10130,10037,8963,9484,578
1041,21171,"Monroe County, Kentucky",10616,11089,11756,11401,12353,-1737
1042,21173,"Montgomery County, Kentucky",28042,25908,22554,19561,20046,7996
1043,21175,"Morgan County, Kentucky",13270,14055,13948,11648,12103,1167
1044,21177,"Muhlenberg County, Kentucky",30815,31541,31839,31318,32238,-1423
1045,21179,"Nelson County, Kentucky",45915,42523,37477,29710,27584,18331
1046,21181,"Nicholas County, Kentucky",7189,7136,6813,6725,7157,32
1047,21183,"Ohio County, Kentucky",24081,23837,22916,21105,21765,2316
1048,21185,"Oldham County, Kentucky",66508,58784,46178,33263,27795,38713
1049,21187,"Owen County, Kentucky",10847,10928,10547,9035,8924,1923
1050,21189,"Owsley County, Kentucky",4416,4742,4858,5036,5709,-1293
1051,21191,"Pendleton County, Kentucky",14587,14894,14390,12036,10989,3598
1052,21193,"Perry County, Kentucky",26266,28739,29390,30283,33763,-7497
1053,21195,"Pike County, Kentucky",58595,65309,68736,72583,81123,-22528
1054,21197,"Powell County, Kentucky",12283,12786,13237,11686,11101,1182
1055,21199,"Pulaski County, Kentucky",64789,62062,56217,49489,45803,18986
1056,21201,"Robertson County, Kentucky",2139,2278,2266,2124,2265,-126
1057,21203,"Rockcastle County, Kentucky",16795,17075,16582,14803,13973,2822
1058,21205,"Rowan County, Kentucky",24534,23075,22094,20353,19049,5485
1059,21207,"Russell County, Kentucky",17846,17445,16315,14716,13708,4138
1060,21209,"Scott County, Kentucky",55961,44868,33061,23867,21813,34148
1061,21211,"Shelby County, Kentucky",48100,40899,33337,24824,23328,24772
1062,21213,"Simpson County, Kentucky",18319,17214,16405,15145,14673,3646
1063,21215,"Spencer County, Kentucky",18945,16582,11766,6801,5929,13016
1064,21217,"Taylor County, Kentucky",25572,24247,22927,21146,21178,4394
1065,21219,"Todd County, Kentucky",12334,12307,11971,10940,11874,460
1066,21221,"Trigg County, Kentucky",14569,14117,12597,10361,9384,5185
1067,21223,"Trimble County, Kentucky",8528,8872,8125,6090,6253,2275
1068,21225,"Union County, Kentucky",14582,15077,15637,16557,17821,-3239
1069,21227,"Warren County, Kentucky",130836,109775,92522,76673,71828,59008
1070,21229,"Washington County, Kentucky",12044,11593,10916,10441,10764,1280
1071,21231,"Wayne County, Kentucky",20447,20716,19923,17468,17022,3425
1072,21233,"Webster County, Kentucky",13021,13734,14120,13955,14832,-1811
1073,21235,"Whitley County, Kentucky",36252,36006,35865,33326,33396,2856
1074,21237,"Wolfe County, Kentucky",7188,7315,7065,6503,6698,490
1075,21239,"Woodford County, Kentucky",26486,24523,23208,19955,17778,8708
1076,22001,"Acadia Parish, Louisiana",62371,61139,58861,55882,56427,5944
1077,22003,"Allen Parish, Louisiana",25572,25816,25440,21226,21390,4182
1078,22005,"Ascension Parish, Louisiana",125061,102501,76627,58214,50068,74993
1079,22007,"Assumption Parish, Louisiana",22236,23487,23388,22753,22084,152
1080,22009,"Avoyelles Parish, Louisiana",40465,42013,41481,39159,41393,-928
1081,22011,"Beauregard Parish, Louisiana",37387,35000,32986,30083,29692,7695
1082,22013,"Bienville Parish, Louisiana",13391,14546,15752,15979,16387,-2996
1083,22015,"Bossier Parish, Louisiana",126952,113837,98310,86088,80721,46231
1084,22017,"Caddo Parish, Louisiana",243243,253048,252161,248253,252358,-9115
1085,22019,"Calcasieu Parish, Louisiana",202858,189134,183577,168134,167223,35635
1086,22021,"Caldwell Parish, Louisiana",9959,10188,10560,9810,10761,-802
1087,22023,"Cameron Parish, Louisiana",6963,7280,9991,9260,9336,-2373
1088,22025,"Catahoula Parish, Louisiana",9586,10465,10920,11065,12287,-2701
1089,22027,"Claiborne Parish, Louisiana",15854,17160,16851,17405,17095,-1241
1090,22029,"Concordia Parish, Louisiana",19533,20502,20247,20828,22981,-3448
1091,22031,"De Soto Parish, Louisiana",27395,26465,25494,25346,25727,1668
1092,22033,"East Baton Rouge Parish, Louisiana",443158,435815,412852,380105,366191,76967
1093,22035,"East Carroll Parish, Louisiana",6947,7964,9421,9709,11772,-4825
1094,22037,"East Feliciana Parish, Louisiana",19228,20417,21360,19211,19015,213
1095,22039,"Evangeline Parish, Louisiana",33491,34419,35434,33274,33343,148
1096,22041,"Franklin Parish, Louisiana",20109,20727,21263,22387,24141,-4032
1097,22043,"Grant Parish, Louisiana",22339,21675,18698,17526,16703,5636
1098,22045,"Iberia Parish, Louisiana",70763,73395,73266,68297,63752,7011
1099,22047,"Iberville Parish, Louisiana",32626,33513,33320,31049,32159,467
1100,22049,"Jackson Parish, Louisiana",15822,16078,15397,15705,17321,-1499
1101,22051,"Jefferson Parish, Louisiana",434903,431019,455466,448306,454592,-19689
1102,22053,"Jefferson Davis Parish, Louisiana",31425,31500,31435,30722,32168,-743
1103,22055,"Lafayette Parish, Louisiana",243692,215581,190503,164762,150017,93675
1104,22057,"Lafourche Parish, Louisiana",97980,95428,89974,85860,82483,15497
1105,22059,"La Salle Parish, Louisiana",14950,14680,14282,13662,17004,-2054
1106,22061,"Lincoln Parish, Louisiana",47118,45797,42509,41745,39763,7355
1107,22063,"Livingston Parish, Louisiana",140524,122798,91814,70526,58806,81718
1108,22065,"Madison Parish, Louisiana",11137,12286,13728,12463,15975,-4838
1109,22067,"Morehouse Parish, Louisiana",25189,28388,31021,31938,34803,-9614
1110,22069,"Natchitoches Parish, Louisiana",38505,39274,39080,36689,39863,-1358
1111,22071,"Orleans Parish, Louisiana",391249,295285,484674,496938,557515,-166266
1112,22073,"Ouachita Parish, Louisiana",154679,152207,147250,142191,139241,15438
1113,22075,"Plaquemines Parish, Louisiana",23305,22710,26757,25575,26049,-2744
1114,22077,"Pointe Coupee Parish, Louisiana",21883,22837,22763,22540,24045,-2162
1115,22079,"Rapides Parish, Louisiana",130376,130800,126337,131556,135282,-4906
1116,22081,"Red River Parish, Louisiana",8462,9181,9622,9387,10433,-1971
1117,22083,"Richland Parish, Louisiana",20251,20692,20981,20629,22187,-1936
1118,22085,"Sabine Parish, Louisiana",23915,24119,23459,22646,25280,-1365
1119,22087,"St. Bernard Parish, Louisiana",46694,27739,67229,66631,64097,-17403
1120,22089,"St. Charles Parish, Louisiana",52856,52645,48072,42437,37259,15597
1121,22091,"St. Helena Parish, Louisiana",10227,11125,10525,9874,9827,400
1122,22093,"St. James Parish, Louisiana",21142,22096,21216,20879,21495,-353
1123,22095,"St. John The Baptist Parish, Louisiana",43055,46728,43044,39996,31924,11131
1124,22097,"St. Landry Parish, Louisiana",82786,84309,87700,80331,84128,-1342
1125,22099,"St. Martin Parish, Louisiana",53607,51721,48583,43978,40214,13393
1126,22101,"St. Mary Parish, Louisiana",50020,54348,53500,58086,64253,-14233
1127,22103,"St. Tammany Parish, Louisiana",258447,228894,191268,144508,110869,147578
1128,22105,"Tangipahoa Parish, Louisiana",133753,118190,100588,85709,80698,53055
1129,22107,"Tensas Parish, Louisiana",4435,5430,6618,7103,8525,-4090
1130,22109,"Terrebonne Parish, Louisiana",111297,111131,104503,96982,94393,16904
1131,22111,"Union Parish, Louisiana",22270,22750,22803,20690,21167,1103
1132,22113,"Vermilion Parish, Louisiana",59787,57280,53807,50055,48458,11329
1133,22115,"Vernon Parish, Louisiana",49315,50451,52531,61961,53475,-4160
1134,22117,"Washington Parish, Louisiana",46325,46578,43926,43185,44207,2118
1135,22119,"Webster Parish, Louisiana",38813,41238,41831,41989,43631,-4818
1136,22121,"West Baton Rouge Parish, Louisiana",26395,23274,21601,19419,19086,7309
1137,22123,"West Carroll Parish, Louisiana",10934,11689,12314,12093,12922,-1988
1138,22125,"West Feliciana Parish, Louisiana",15441,15681,15111,12915,12186,3255
1139,22127,"Winn Parish, Louisiana",14165,15477,16894,16269,17253,-3088
1140,23001,"Androscoggin County, Maine",107958,107882,103793,105259,99657,8301
1141,23003,"Aroostook County, Maine",67431,72412,73938,86936,91331,-23900
1142,23005,"Cumberland County, Maine",294520,279994,265612,243135,215789,78731
1143,23007,"Franklin County, Maine",29933,30657,29467,29008,27098,2835
1144,23009,"Hancock County, Maine",54832,54309,51791,46948,41781,13051
1145,23011,"Kennebec County, Maine",122158,121925,117114,115904,109889,12269
1146,23013,"Knox County, Maine",39809,40111,39618,36310,32941,6868
1147,23015,"Lincoln County, Maine",34415,34719,33616,30357,25691,8724
1148,23017,"Oxford County, Maine",57741,57867,54755,52602,48968,8773
1149,23019,"Penobscot County, Maine",151696,152934,144919,146601,137015,14681
1150,23021,"Piscataquis County, Maine",16864,17555,17235,18653,17634,-770
1151,23023,"Sagadahoc County, Maine",35720,35688,35214,33535,28795,6925
1152,23025,"Somerset County, Maine",50573,52261,50888,49767,45028,5545
1153,23027,"Waldo County, Maine",39723,38740,36280,33018,28414,11309
1154,23029,"Washington County, Maine",31378,33154,33941,35308,34963,-3585
1155,23031,"York County, Maine",206074,197457,186742,164587,139666,66408
1156,24001,"Allegany County, Maryland",71002,74638,74930,74946,80548,-9546
1157,24003,"Anne Arundel County, Maryland",575421,527020,489656,427239,370775,204646
1158,24005,"Baltimore County, Maryland",828193,799195,754292,692134,655615,172578
1159,24009,"Calvert County, Maryland",92094,87891,74563,51372,34638,57456
1160,24011,"Caroline County, Maryland",33260,32805,29772,27035,23143,10117
1161,24013,"Carroll County, Maryland",168233,167208,150897,123372,96356,71877
1162,24015,"Cecil County, Maryland",102889,100139,85951,71347,60430,42459
1163,24017,"Charles County, Maryland",161448,143912,120546,101154,72751,88697
1164,24019,"Dorchester County, Maryland",31994,32287,30674,30236,30623,1371
1165,24021,"Frederick County, Maryland",255955,229205,195277,150208,114792,141163
1166,24023,"Garrett County, Maryland",29155,30145,29846,28138,26498,2657
1167,24025,"Harford County, Maryland",253736,242888,218590,182132,145930,107806
1168,24027,"Howard County, Maryland",322407,279366,247842,187328,118572,203835
1169,24029,"Kent County, Maryland",19456,20018,19197,17842,16695,2761
1170,24031,"Montgomery County, Maryland",1047661,947230,873341,757027,579053,468608
1171,24033,"Prince George's County, Maryland",910551,854722,801515,729268,665071,245480
1172,24035,"Queen Anne's County, Maryland",50163,46945,40563,33953,25508,24655
1173,24037,"St. Mary's County, Maryland",113182,102086,86211,75974,59895,53287
1174,24039,"Somerset County, Maryland",25699,26411,24747,23440,19188,6511
1175,24041,"Talbot County, Maryland",37087,37361,33812,30549,25604,11483
1176,24043,"Washington County, Maryland",150575,146329,131923,121393,113086,37489
1177,24045,"Wicomico County, Maryland",103222,96951,84644,74339,64540,38682
1178,24047,"Worcester County, Maryland",51967,51133,46543,35028,30889,21078
1179,24510,"Baltimore City, Maryland",602274,620538,651154,736014,786775,-184501
1180,25001,"Barnstable County, Massachusetts",213505,217483,222230,186605,147925,65580
1181,25003,"Berkshire County, Massachusetts",125927,131528,134953,139352,145110,-19183
1182,25005,"Bristol County, Massachusetts",563301,546433,534678,506325,474641,88660
1183,25007,"Dukes County, Massachusetts",17430,16155,14987,11639,8942,8488
1184,25009,"Essex County, Massachusetts",787038,735642,723419,670080,633632,153406
1185,25011,"Franklin County, Massachusetts",70529,71523,71535,70092,64317,6212
1186,25013,"Hampden County, Massachusetts",466647,462270,456228,456310,443018,23629
1187,25015,"Hampshire County, Massachusetts",161361,157326,152251,146568,138813,22548
1188,25017,"Middlesex County, Massachusetts",1605899,1479491,1465396,1398468,1367034,238865
1189,25019,"Nantucket County, Massachusetts",11212,10069,9520,6012,5087,6125
1190,25021,"Norfolk County, Massachusetts",703740,662077,650308,616087,606587,97153
1191,25023,"Plymouth County, Massachusetts",518597,490784,472822,435276,405437,113160
1192,25025,"Suffolk County, Massachusetts",801162,704460,689807,663906,650142,151020
1193,25027,"Worcester County, Massachusetts",826655,791855,750963,709705,646352,180303
1194,26001,"Alcona County, Michigan",10396,11238,11719,10145,9740,656
1195,26003,"Alger County, Michigan",9098,9604,9862,8972,9225,-127
1196,26005,"Allegan County, Michigan",117104,111385,105665,90509,81555,35549
1197,26007,"Alpena County, Michigan",28431,29958,31314,30605,32315,-3884
1198,26009,"Antrim County, Michigan",23301,23975,23110,18185,16194,7107
1199,26011,"Arenac County, Michigan",15013,16487,17269,14931,14706,307
1200,26013,"Baraga County, Michigan",8337,8882,8746,7954,8484,-147
1201,26015,"Barry County, Michigan",61045,59576,56755,50057,45781,15264
1202,26017,"Bay County, Michigan",103506,108156,110157,111723,119881,-16375
1203,26019,"Benzie County, Michigan",17703,17705,15998,12200,11205,6498
1204,26021,"Berrien County, Michigan",153797,157232,162453,161378,171276,-17479
1205,26023,"Branch County, Michigan",43428,46083,45787,41502,40188,3240
1206,26025,"Calhoun County, Michigan",133943,137112,137985,135982,141557,-7614
1207,26027,"Cass County, Michigan",51613,52429,51104,49477,49499,2114
1208,26029,"Charlevoix County, Michigan",26197,26228,26090,21468,19907,6290
1209,26031,"Cheboygan County, Michigan",25435,26699,26448,21398,20649,4786
1210,26033,"Chippewa County, Michigan",37418,39078,38543,34604,29029,8389
1211,26035,"Clare County, Michigan",30655,31162,31252,24952,23822,6833
1212,26037,"Clinton County, Michigan",78957,74235,64753,57883,55893,23064
1213,26039,"Crawford County, Michigan",13904,14325,14273,12260,9465,4439
1214,26041,"Delta County, Michigan",35874,37403,38520,37780,38947,-3073
1215,26043,"Dickinson County, Michigan",25373,26584,27472,26831,25341,32
1216,26045,"Eaton County, Michigan",109730,108002,103655,92879,88337,21393
1217,26047,"Emmet County, Michigan",33175,32806,31437,25040,22992,10183
1218,26049,"Genesee County, Michigan",406770,433054,436141,430459,450449,-43679
1219,26051,"Gladwin County, Michigan",25312,26076,26023,21896,19957,5355
1220,26053,"Gogebic County, Michigan",14715,16471,17370,18052,19686,-4971
1221,26055,"Grand Traverse County, Michigan",92640,86061,77654,64273,54899,37741
1222,26057,"Gratiot County, Michigan",40692,42612,42285,38982,40448,244
1223,26059,"Hillsdale County, Michigan",45707,47033,46527,43431,42071,3636
1224,26061,"Houghton County, Michigan",35890,36192,36016,35446,37872,-1982
1225,26063,"Huron County, Michigan",31105,33642,36079,34951,36459,-5354
1226,26065,"Ingham County, Michigan",290923,281365,279320,281912,275520,15403
1227,26067,"Ionia County, Michigan",64401,64651,61518,57024,51815,12586
1228,26069,"Iosco County, Michigan",25213,26422,27339,30209,28349,-3136
1229,26071,"Iron County, Michigan",11099,12057,13138,13175,13635,-2536
1230,26073,"Isabella County, Michigan",70363,69451,63351,54624,54110,16253
1231,26075,"Jackson County, Michigan",158174,161569,158422,149756,151495,6679
1232,26077,"Kalamazoo County, Michigan",264322,247246,238603,223411,212378,51944
1233,26079,"Kalkaska County, Michigan",17725,17400,16571,13497,10952,6773
1234,26081,"Kent County, Michigan",652617,599432,574335,500631,444506,208111
1235,26083,"Keweenaw County, Michigan",2102,2122,2301,1701,1963,139
1236,26085,"Lake County, Michigan",11805,11625,11333,8583,7711,4094
1237,26087,"Lapeer County, Michigan",87975,89944,87904,74768,70038,17937
1238,26089,"Leelanau County, Michigan",21649,21757,21119,16527,14007,7642
1239,26091,"Lenawee County, Michigan",98310,100911,98890,91476,89948,8362
1240,26093,"Livingston County, Michigan",190832,181350,156951,115645,100289,90543
1241,26095,"Luce County, Michigan",6286,6685,7024,5763,6659,-373
1242,26097,"Mackinac County, Michigan",10781,11281,11943,10674,10178,603
1243,26099,"Macomb County, Michigan",870893,837490,788149,717400,694600,176293
1244,26101,"Manistee County, Michigan",24539,24951,24527,21265,23019,1520
1245,26103,"Marquette County, Michigan",66403,66514,64634,70887,74101,-7698
1246,26105,"Mason County, Michigan",29062,28715,28274,25537,26365,2697
1247,26107,"Mecosta County, Michigan",43481,42730,40553,37308,36961,6520
1248,26109,"Menominee County, Michigan",22902,24245,25326,24920,26201,-3299
1249,26111,"Midland County, Michigan",83445,83626,82874,75651,73578,9867
1250,26113,"Missaukee County, Michigan",15075,14962,14478,12147,10009,5066
1251,26115,"Monroe County, Michigan",150000,152784,145945,133600,134659,15341
1252,26117,"Montcalm County, Michigan",63516,63553,61266,53059,47555,15961
1253,26119,"Montmorency County, Michigan",9270,9920,10315,8936,7492,1778
1254,26121,"Muskegon County, Michigan",173679,173223,170200,158983,157589,16090
1255,26123,"Newaygo County, Michigan",48687,48962,47874,38202,34917,13770
1256,26125,"Oakland County, Michigan",1255340,1201113,1194156,1083592,1011793,243547
1257,26127,"Oceana County, Michigan",26545,27029,26873,22454,22002,4543
1258,26129,"Ogemaw County, Michigan",20895,21862,21645,18681,16436,4459
1259,26131,"Ontonagon County, Michigan",5802,6976,7818,8854,9861,-4059
1260,26133,"Osceola County, Michigan",23323,23681,23197,20146,18928,4395
1261,26135,"Oscoda County, Michigan",8282,8884,9418,7842,6858,1424
1262,26137,"Otsego County, Michigan",24613,24445,23301,17957,14993,9620
1263,26139,"Ottawa County, Michigan",289162,261376,238314,187768,157174,131988
1264,26141,"Presque Isle County, Michigan",12687,13697,14411,13743,14267,-1580
1265,26143,"Roscommon County, Michigan",23863,24932,25469,19776,16374,7489
1266,26145,"Saginaw County, Michigan",191166,202336,210039,211946,228059,-36893
1267,26147,"St. Clair County, Michigan",159285,165719,164235,145607,138802,20483
1268,26149,"St. Joseph County, Michigan",60789,61848,62422,58913,56083,4706
1269,26151,"Sanilac County, Michigan",41179,44010,44547,39928,40789,390
1270,26153,"Schoolcraft County, Michigan",8031,8640,8903,8302,8575,-544
1271,26155,"Shiawassee County, Michigan",68176,71621,71687,69770,71140,-2964
1272,26157,"Tuscola County, Michigan",52683,56543,58266,55498,56961,-4278
1273,26159,"Van Buren County, Michigan",75416,76585,76263,70060,66814,8602
1274,26161,"Washtenaw County, Michigan",368385,343947,322895,282937,264748,103637
1275,26163,"Wayne County, Michigan",1753059,1870362,2061162,2111687,2337891,-584832
1276,26165,"Wexford County, Michigan",33433,32653,30484,26360,25102,8331
1277,27001,"Aitkin County, Minnesota",15826,16325,15301,12425,13404,2422
1278,27003,"Anoka County, Minnesota",353775,327544,298084,243641,195998,157777
1279,27005,"Becker County, Minnesota",34227,32274,30000,27881,29336,4891
1280,27007,"Beltrami County, Minnesota",46784,43781,39650,34384,30982,15802
1281,27009,"Benton County, Minnesota",40476,38148,34226,30185,25187,15289
1282,27011,"Big Stone County, Minnesota",4974,5324,5820,6285,7716,-2742
1283,27013,"Blue Earth County, Minnesota",67368,62719,55941,54044,52314,15054
1284,27015,"Brown County, Minnesota",25076,26030,26911,26984,28645,-3569
1285,27017,"Carlton County, Minnesota",35709,34958,31671,29259,29936,5773
1286,27019,"Carver County, Minnesota",103561,88668,70205,47915,37046,66515
1287,27021,"Cass County, Minnesota",29462,28648,27150,21791,21050,8412
1288,27023,"Chippewa County, Minnesota",11876,12426,13088,13228,14941,-3065
1289,27025,"Chisago County, Minnesota",55844,52844,41101,30521,25717,30127
1290,27027,"Clay County, Minnesota",64029,57089,51229,50422,49327,14702
1291,27029,"Clearwater County, Minnesota",8872,8593,8423,8309,8761,111
1292,27031,"Cook County, Minnesota",5402,5211,5168,3868,4092,1310
1293,27033,"Cottonwood County, Minnesota",11279,11712,12167,12694,14854,-3575
1294,27035,"Crow Wing County, Minnesota",64775,61836,55099,44249,41722,23053
1295,27037,"Dakota County, Minnesota",425271,393380,355904,275227,194279,230992
1296,27039,"Dodge County, Minnesota",20807,19829,17731,15731,14773,6034
1297,27041,"Douglas County, Minnesota",37820,35909,32821,28674,27839,9981
1298,27043,"Faribault County, Minnesota",13727,14819,16181,16937,19714,-5987
1299,27045,"Fillmore County, Minnesota",21031,20978,21122,20777,21930,-899
1300,27047,"Freeborn County, Minnesota",30465,31387,32584,33060,36329,-5864
1301,27049,"Goodhue County, Minnesota",46330,45930,44127,40690,38749,7581
1302,27051,"Grant County, Minnesota",5962,6082,6289,6246,7171,-1209
1303,27053,"Hennepin County, Minnesota",1255296,1136522,1116200,1032431,941411,313885
1304,27055,"Houston County, Minnesota",18670,19226,19718,18497,18382,288
1305,27057,"Hubbard County, Minnesota",21287,20205,18376,14939,14098,7189
1306,27059,"Isanti County, Minnesota",40004,37682,31287,25921,23600,16404
1307,27061,"Itasca County, Minnesota",45180,44835,43992,40863,43069,2111
1308,27063,"Jackson County, Minnesota",9873,10403,11268,11677,13690,-3817
1309,27065,"Kanabec County, Minnesota",16205,16379,14996,12802,12161,4044
1310,27067,"Kandiyohi County, Minnesota",42909,41869,41203,38761,36763,6146
1311,27069,"Kittson County, Minnesota",4272,4620,5285,5767,6672,-2400
1312,27071,"Koochiching County, Minnesota",12355,13461,14355,16299,17571,-5216
1313,27073,"Lac Qui Parle County, Minnesota",6645,7343,8067,8924,10592,-3947
1314,27075,"Lake County, Minnesota",10571,10900,11058,10415,13043,-2472
1315,27077,"Lake Of The Woods County, Minnesota",3747,4147,4522,4076,3764,-17
1316,27079,"Le Sueur County, Minnesota",28425,27719,25426,23239,23434,4991
1317,27081,"Lincoln County, Minnesota",5641,5935,6429,6890,8207,-2566
1318,27083,"Lyon County, Minnesota",25696,25606,25425,24789,25207,489
1319,27085,"Mcleod County, Minnesota",35788,36789,34898,32030,29657,6131
1320,27087,"Mahnomen County, Minnesota",5508,5359,5190,5044,5535,-27
1321,27089,"Marshall County, Minnesota",9353,9580,10155,10993,13027,-3674
1322,27091,"Martin County, Minnesota",19737,20865,21802,22914,24687,-4950
1323,27093,"Meeker County, Minnesota",23149,23371,22644,20846,20594,2555
1324,27095,"Mille Lacs County, Minnesota",25963,26075,22330,18670,18430,7533
1325,27097,"Morrison County, Minnesota",33119,33093,31712,29604,29311,3808
1326,27099,"Mower County, Minnesota",39931,38855,38603,37385,40390,-459
1327,27101,"Murray County, Minnesota",8247,8779,9165,9660,11507,-3260
1328,27103,"Nicollet County, Minnesota",34176,32271,29771,28076,26929,7247
1329,27105,"Nobles County, Minnesota",21667,21030,20832,20098,21840,-173
1330,27107,"Norman County, Minnesota",6466,6865,7442,7975,9379,-2913
1331,27109,"Olmsted County, Minnesota",156446,141244,124277,106470,92006,64440
1332,27111,"Otter Tail County, Minnesota",58416,57539,57159,50714,51937,6479
1333,27113,"Pennington County, Minnesota",14110,13862,13584,13306,15258,-1148
1334,27115,"Pine County, Minnesota",29254,29413,26530,21264,19871,9383
1335,27117,"Pipestone County, Minnesota",9163,9570,9895,10491,11690,-2527
1336,27119,"Polk County, Minnesota",31384,31336,31369,32498,34844,-3460
1337,27121,"Pope County, Minnesota",11107,11064,11236,10745,11657,-550
1338,27123,"Ramsey County, Minnesota",546598,503113,511035,485765,459784,86814
1339,27125,"Red Lake County, Minnesota",4005,4094,4299,4525,5471,-1466
1340,27127,"Redwood County, Minnesota",15193,16069,16815,17254,19341,-4148
1341,27129,"Renville County, Minnesota",14572,16007,17154,17673,20401,-5829
1342,27131,"Rice County, Minnesota",66549,63087,56665,49183,46087,20462
1343,27133,"Rock County, Minnesota",9386,9606,9721,9806,10703,-1317
1344,27135,"Roseau County, Minnesota",15259,15864,16338,15026,12574,2685
1345,27137,"St. Louis County, Minnesota",199499,199472,200528,198213,222229,-22730
1346,27139,"Scott County, Minnesota",147201,126139,89498,57846,43784,103417
1347,27141,"Sherburne County, Minnesota",96015,86823,64417,41945,29908,66107
1348,27143,"Sibley County, Minnesota",14871,15219,15356,14366,15448,-577
1349,27145,"Stearns County, Minnesota",159788,147927,133166,118791,108161,51627
1350,27147,"Steele County, Minnesota",36710,36434,33680,30729,30328,6382
1351,27149,"Stevens County, Minnesota",9770,9711,10053,10634,11322,-1552
1352,27151,"Swift County, Minnesota",9329,9946,11956,10724,12920,-3591
1353,27153,"Todd County, Minnesota",24603,24804,24426,23363,24991,-388
1354,27155,"Traverse County, Minnesota",3282,3657,4134,4463,5542,-2260
1355,27157,"Wabasha County, Minnesota",21564,21743,21610,19744,19335,2229
1356,27159,"Wadena County, Minnesota",13681,13809,13713,13154,14192,-511
1357,27161,"Waseca County, Minnesota",18658,19168,19526,18079,18448,210
1358,27163,"Washington County, Minnesota",259072,232536,201130,145896,113571,145501
1359,27165,"Watonwan County, Minnesota",10903,11212,11876,11682,12361,-1458
1360,27167,"Wilkin County, Minnesota",6264,6636,7138,7516,8454,-2190
1361,27169,"Winona County, Minnesota",50744,51304,49985,47828,46256,4488
1362,27171,"Wright County, Minnesota",136387,120764,89986,68710,58681,77706
1363,27173,"Yellow Medicine County, Minnesota",9775,10514,11080,11684,13653,-3878
1364,28001,"Adams County, Mississippi",31103,32659,34340,35356,38035,-6932
1365,28003,"Alcorn County, Mississippi",37058,36708,34558,31722,33036,4022
1366,28005,"Amite County, Mississippi",12341,13318,13599,13328,13369,-1028
1367,28007,"Attala County, Mississippi",18308,19545,19661,18481,19865,-1557
1368,28009,"Benton County, Mississippi",8275,8652,8026,8046,8153,122
1369,28011,"Bolivar County, Mississippi",31253,35063,40633,41875,45965,-14712
1370,28013,"Calhoun County, Mississippi",14417,14945,15069,14908,15664,-1247
1371,28015,"Carroll County, Mississippi",9972,10608,10769,9237,9776,196
1372,28017,"Chickasaw County, Mississippi",17060,17689,19440,18085,17853,-793
1373,28019,"Choctaw County, Mississippi",8206,8680,9758,9071,8996,-790
1374,28021,"Claiborne County, Mississippi",9042,9928,11831,11370,12279,-3237
1375,28023,"Clarke County, Mississippi",15612,16808,17955,17313,16945,-1333
1376,28025,"Clay County, Mississippi",19515,20883,21979,21120,21082,-1567
1377,28027,"Coahoma County, Mississippi",22685,26681,30622,31665,36918,-14233
1378,28029,"Copiah County, Mississippi",28339,29521,28757,27592,26503,1836
1379,28031,"Covington County, Mississippi",18810,19557,19407,16527,15927,2883
1380,28033,"De Soto County, Mississippi",182256,154715,107199,67910,53930,128326
1381,28035,"Forrest County, Mississippi",75162,74290,72604,68314,66018,9144
1382,28037,"Franklin County, Mississippi",7716,8130,8448,8377,8208,-492
1383,28039,"George County, Mississippi",24098,22061,19144,16673,15297,8801
1384,28041,"Greene County, Mississippi",13619,14009,13299,10220,9827,3792
1385,28043,"Grenada County, Mississippi",20927,22169,23263,21555,21043,-116
1386,28045,"Hancock County, Mississippi",47339,42408,42967,31760,24537,22802
1387,28047,"Harrison County, Mississippi",206169,181791,189601,165365,157665,48504
1388,28049,"Hinds County, Mississippi",235604,246067,250800,254441,250998,-15394
1389,28051,"Holmes County, Mississippi",17414,19597,21609,21604,22970,-5556
1390,28053,"Humphreys County, Mississippi",8198,9610,11206,12134,13931,-5733
1391,28055,"Issaquena County, Mississippi",1223,1893,2274,1909,2513,-1290
1392,28057,"Itawamba County, Mississippi",23396,23329,22770,20017,20518,2878
1393,28059,"Jackson County, Mississippi",142872,137082,131420,115243,118015,24857
1394,28061,"Jasper County, Mississippi",16454,17383,18149,17114,17265,-811
1395,28063,"Jefferson County, Mississippi",7129,7970,9740,8653,9181,-2052
1396,28065,"Jefferson Davis County, Mississippi",11182,12666,13962,14051,13846,-2664
1397,28067,"Jones County, Mississippi",68307,67144,64958,62031,61912,6395
1398,28069,"Kemper County, Mississippi",9829,10470,10453,10356,10148,-319
1399,28071,"Lafayette County, Mississippi",54059,45859,38744,31826,31030,23029
1400,28073,"Lamar County, Mississippi",62693,52559,39070,30424,23821,38872
1401,28075,"Lauderdale County, Mississippi",75557,79405,78161,75555,77285,-1728
1402,28077,"Lawrence County, Mississippi",12595,13016,13258,12458,12518,77
1403,28079,"Leake County, Mississippi",22791,23547,20940,18436,18790,4001
1404,28081,"Lee County, Mississippi",85304,81446,75755,65581,57061,28243
1405,28083,"Leflore County, Mississippi",28764,33109,37947,37341,41525,-12761
1406,28085,"Lincoln County, Mississippi",34197,34622,33166,30278,30174,4023
1407,28087,"Lowndes County, Mississippi",58896,59482,61586,59308,57304,1592
1408,28089,"Madison County, Mississippi",105482,91987,74674,53794,41613,63869
1409,28091,"Marion County, Mississippi",24785,26758,25595,25544,25708,-923
1410,28093,"Marshall County, Mississippi",35502,37002,34993,30361,29296,6206
1411,28095,"Monroe County, Mississippi",35559,37282,38014,36582,36404,-845
1412,28097,"Montgomery County, Mississippi",9956,11138,12189,12388,13366,-3410
1413,28099,"Neshoba County, Mississippi",29250,29545,28684,24800,23789,5461
1414,28101,"Newton County, Mississippi",21215,21828,21838,20291,19944,1271
1415,28103,"Noxubee County, Mississippi",10566,11747,12548,12604,13212,-2646
1416,28105,"Oktibbeha County, Mississippi",49593,46529,42902,38375,36018,13575
1417,28107,"Panola County, Mississippi",34079,34782,34274,29996,28164,5915
1418,28109,"Pearl River County, Mississippi",55512,55923,48621,38714,33795,21717
1419,28111,"Perry County, Mississippi",11981,12243,12138,10865,9864,2117
1420,28113,"Pike County, Mississippi",39365,40284,38940,36882,36173,3192
1421,28115,"Pontotoc County, Mississippi",31996,29523,26726,22237,20918,11078
1422,28117,"Prentiss County, Mississippi",25155,25411,25556,23278,24025,1130
1423,28119,"Quitman County, Mississippi",7038,8551,10117,10490,12636,-5598
1424,28121,"Rankin County, Mississippi",154119,138523,115327,87161,69427,84692
1425,28123,"Scott County, Mississippi",28288,28180,28423,24137,24556,3732
1426,28125,"Sharkey County, Mississippi",4427,4797,6580,7066,7964,-3537
1427,28127,"Simpson County, Mississippi",26818,27575,27639,23953,23441,3377
1428,28129,"Smith County, Mississippi",15919,16443,16182,14798,15077,842
1429,28131,"Stone County, Mississippi",18282,16923,13622,10750,9716,8566
1430,28133,"Sunflower County, Mississippi",25759,30504,34369,32867,34844,-9085
1431,28135,"Tallahatchie County, Mississippi",14041,15270,14903,15210,17157,-3116
1432,28137,"Tate County, Mississippi",28419,28198,25370,21432,20119,8300
1433,28139,"Tippah County, Mississippi",21976,21993,20826,19523,18739,3237
1434,28141,"Tishomingo County, Mississippi",19396,19535,19163,17683,18434,962
1435,28143,"Tunica County, Mississippi",9807,10817,9227,8164,9652,155
1436,28145,"Union County, Mississippi",28578,26922,25362,22085,21741,6837
1437,28147,"Walthall County, Mississippi",14423,15530,15156,14352,13761,662
1438,28149,"Warren County, Mississippi",46030,48890,49644,47880,51627,-5597
1439,28151,"Washington County, Mississippi",45072,52455,62977,67935,72344,-27272
1440,28153,"Wayne County, Mississippi",20344,20971,21216,19517,19135,1209
1441,28155,"Webster County, Mississippi",9727,10139,10294,10222,10300,-573
1442,28157,"Wilkinson County, Mississippi",8727,10070,10312,9678,10021,-1294
1443,28159,"Winston County, Mississippi",18116,19378,20160,19433,19474,-1358
1444,28161,"Yalobusha County, Mississippi",12276,12869,13051,12033,13139,-863
1445,28163,"Yazoo County, Mississippi",28511,28402,28149,25506,27349,1162
1446,29001,"Adair County, Missouri",25468,25315,24977,24577,24870,598
1447,29003,"Andrew County, Missouri",17554,17006,16492,14632,13980,3574
1448,29005,"Atchison County, Missouri",5180,5811,6430,7457,8605,-3425
1449,29007,"Audrain County, Missouri",25336,25684,25853,23599,26458,-1122
1450,29009,"Barry County, Missouri",35615,35753,34010,27547,24408,11207
1451,29011,"Barton County, Missouri",11732,12634,12541,11312,11292,440
1452,29013,"Bates County, Missouri",16282,17132,16653,15025,15873,409
1453,29015,"Benton County, Missouri",19305,18975,17180,13859,12183,7122
1454,29017,"Bollinger County, Missouri",12181,12445,12029,10619,10301,1880
1455,29019,"Boone County, Missouri",179704,158067,135454,112379,100376,79328
1456,29021,"Buchanan County, Missouri",87904,88195,85998,83083,87888,16
1457,29023,"Butler County, Missouri",42570,42437,40867,38765,37693,4877
1458,29025,"Caldwell County, Missouri",9052,9380,8969,8380,8660,392
1459,29027,"Callaway County, Missouri",44944,43769,40766,32809,32252,12692
1460,29029,"Camden County, Missouri",45823,43157,37051,27495,20017,25806
1461,29031,"Cape Girardeau County, Missouri",78834,74283,68693,61633,58837,19997
1462,29033,"Carroll County, Missouri",8723,9485,10285,10748,12131,-3408
1463,29035,"Carter County, Missouri",6085,6141,5941,5515,5428,657
1464,29037,"Cass County, Missouri",104687,97598,82092,63808,51029,53658
1465,29039,"Cedar County, Missouri",14144,14091,13733,12093,11894,2250
1466,29041,"Chariton County, Missouri",7449,7871,8438,9202,10489,-3040
1467,29043,"Christian County, Missouri",87324,74156,54285,32644,22402,64922
1468,29045,"Clark County, Missouri",6783,7169,7416,7547,8493,-1710
1469,29047,"Clay County, Missouri",246480,215015,184006,153411,136488,109992
1470,29049,"Clinton County, Missouri",20503,20682,18979,16595,15916,4587
1471,29051,"Cole County, Missouri",76630,74767,71397,63579,56663,19967
1472,29053,"Cooper County, Missouri",17522,17583,16670,14835,14643,2879
1473,29055,"Crawford County, Missouri",23984,24640,22804,19173,18300,5684
1474,29057,"Dade County, Missouri",7571,7929,7923,7449,7383,188
1475,29059,"Dallas County, Missouri",16841,16813,15661,12646,12096,4745
1476,29061,"Daviess County, Missouri",8294,8359,8016,7865,8905,-611
1477,29063,"De Kalb County, Missouri",11872,12872,11597,9967,8222,3650
1478,29065,"Dent County, Missouri",15518,15497,14927,13702,14517,1001
1479,29067,"Douglas County, Missouri",13335,13689,13084,11876,11594,1741
1480,29069,"Dunklin County, Missouri",29657,32140,33155,33112,36324,-6667
1481,29071,"Franklin County, Missouri",103629,100737,93807,80603,71233,32396
1482,29073,"Gasconade County, Missouri",14673,15334,15342,14006,13181,1492
1483,29075,"Gentry County, Missouri",6576,6760,6861,6848,7887,-1311
1484,29077,"Greene County, Missouri",291574,270190,240391,207949,185302,106272
1485,29079,"Grundy County, Missouri",9885,10214,10432,10536,11959,-2074
1486,29081,"Harrison County, Missouri",8427,8941,8850,8469,9890,-1463
1487,29083,"Henry County, Missouri",21854,22373,21997,20044,19672,2182
1488,29085,"Hickory County, Missouri",9452,9579,8940,7335,6367,3085
1489,29087,"Holt County, Missouri",4374,4944,5351,6034,6882,-2508
1490,29089,"Howard County, Missouri",10022,10120,10212,9631,10008,14
1491,29091,"Howell County, Missouri",40130,39763,37238,31447,28807,11323
1492,29093,"Iron County, Missouri",10150,10670,10697,10726,11084,-934
1493,29095,"Jackson County, Missouri",700733,666997,654880,633232,629266,71467
1494,29097,"Jasper County, Missouri",120528,115029,104686,90465,86958,33570
1495,29099,"Jefferson County, Missouri",224777,216262,198099,171380,146183,78594
1496,29101,"Johnson County, Missouri",53948,52041,48258,42514,39059,14889
1497,29103,"Knox County, Missouri",3948,4134,4361,4482,5508,-1560
1498,29105,"Laclede County, Missouri",35680,35357,32513,27158,24323,11357
1499,29107,"Lafayette County, Missouri",32697,33313,32960,31107,29925,2772
1500,29109,"Lawrence County, Missouri",38241,38373,35204,30236,28973,9268
1501,29111,"Lewis County, Missouri",9898,10235,10494,10233,10901,-1003
1502,29113,"Lincoln County, Missouri",57590,51333,38944,28892,22193,35397
1503,29115,"Linn County, Missouri",12004,12824,13754,13885,15495,-3491
1504,29117,"Livingston County, Missouri",14969,14961,14558,14592,15739,-770
1505,29119,"Mcdonald County, Missouri",22882,23016,21681,16938,14917,7965
1506,29121,"Macon County, Missouri",15154,15539,15762,15345,16313,-1159
1507,29123,"Madison County, Missouri",12176,12269,11800,11127,10725,1451
1508,29125,"Maries County, Missouri",8791,9203,8903,7976,7551,1240
1509,29127,"Marion County, Missouri",28572,28579,28289,27682,28638,-66
1510,29129,"Mercer County, Missouri",3623,3731,3757,3723,4685,-1062
1511,29131,"Miller County, Missouri",25369,24805,23564,20700,18532,6837
1512,29133,"Mississippi County, Missouri",13328,14143,13427,14442,15726,-2398
1513,29135,"Moniteau County, Missouri",15907,15468,14827,12298,12068,3839
1514,29137,"Monroe County, Missouri",8630,9078,9311,9104,9716,-1086
1515,29139,"Montgomery County, Missouri",11414,12247,12136,11355,11537,-123
1516,29141,"Morgan County, Missouri",20438,20631,19309,15574,13807,6631
1517,29143,"New Madrid County, Missouri",17275,18847,19760,20928,22945,-5670
1518,29145,"Newton County, Missouri",58288,57561,52636,44445,40555,17733
1519,29147,"Nodaway County, Missouri",22199,23031,21912,21709,21996,203
1520,29149,"Oregon County, Missouri",10561,10739,10344,9470,10238,323
1521,29151,"Osage County, Missouri",13613,13768,13062,12018,12014,1599
1522,29153,"Ozark County, Missouri",9138,9688,9542,8598,7961,1177
1523,29155,"Pemiscot County, Missouri",16330,18587,20047,21921,24987,-8657
1524,29157,"Perry County, Missouri",19227,18919,18132,16648,16784,2443
1525,29159,"Pettis County, Missouri",42421,41587,39403,35437,36378,6043
1526,29161,"Phelps County, Missouri",44587,44473,39825,35248,33633,10954
1527,29163,"Pike County, Missouri",18158,18590,18351,15969,17568,590
1528,29165,"Platte County, Missouri",102848,86894,73781,57867,46341,56507
1529,29167,"Polk County, Missouri",32031,30729,26992,21826,18822,13209
1530,29169,"Pulaski County, Missouri",52359,49114,41165,41307,42011,10348
1531,29171,"Putnam County, Missouri",4746,5040,5223,5079,6092,-1346
1532,29173,"Ralls County, Missouri",10258,10127,9626,8476,8911,1347
1533,29175,"Randolph County, Missouri",24769,25495,24663,24370,25460,-691
1534,29177,"Ray County, Missouri",22900,23667,23354,21971,21378,1522
1535,29179,"Reynolds County, Missouri",6274,6698,6689,6661,7230,-956
1536,29181,"Ripley County, Missouri",13484,14057,13509,12303,12458,1026
1537,29183,"St. Charles County, Missouri",398472,350606,283883,212907,144107,254365
1538,29185,"St. Clair County, Missouri",9455,9757,9652,8457,8622,833
1539,29186,"Ste. Genevieve County, Missouri",17887,18205,17842,16037,15180,2707
1540,29187,"St. Francois County, Missouri",66653,64239,55641,48904,42600,24053
1541,29189,"St. Louis County, Missouri",996179,999454,1016315,993529,973896,22283
1542,29195,"Saline County, Missouri",22932,23126,23756,23523,24919,-1987
1543,29197,"Schuyler County, Missouri",4550,4361,4170,4236,4979,-429
1544,29199,"Scotland County, Missouri",4923,4831,4983,4822,5415,-492
1545,29201,"Scott County, Missouri",38538,39370,40422,39376,39647,-1109
1546,29203,"Shannon County, Missouri",8207,8404,8324,7613,7885,322
1547,29205,"Shelby County, Missouri",5975,6439,6799,6942,7826,-1851
1548,29207,"Stoddard County, Missouri",29255,30089,29705,28895,29009,246
1549,29209,"Stone County, Missouri",31875,32003,28658,19078,15587,16288
1550,29211,"Sullivan County, Missouri",6163,6728,7219,6326,7434,-1271
1551,29213,"Taney County, Missouri",55563,49324,39703,25561,20467,35096
1552,29215,"Texas County, Missouri",25518,25662,23003,21476,21070,4448
1553,29217,"Vernon County, Missouri",20560,20917,20454,19041,19806,754
1554,29219,"Warren County, Missouri",35090,31635,24525,19534,14900,20190
1555,29221,"Washington County, Missouri",24819,24981,23344,20380,17983,6836
1556,29223,"Wayne County, Missouri",13058,13433,13259,11543,11277,1781
1557,29225,"Webster County, Missouri",39127,35678,31045,23753,20414,18713
1558,29227,"Worth County, Missouri",2001,2188,2382,2440,3008,-1007
1559,29229,"Wright County, Missouri",18256,18731,17955,16758,16188,2068
1560,29510,"St. Louis City, Missouri",304709,318809,348189,396685,453085,-148376
1561,30001,"Beaverhead County, Montana",9454,9132,9202,8424,8186,1268
1562,30003,"Big Horn County, Montana",13302,12663,12671,11337,11096,2206
1563,30005,"Blaine County, Montana",6698,6472,7009,6728,6999,-301
1564,30007,"Broadwater County, Montana",6080,5287,4385,3318,3267,2813
1565,30009,"Carbon County, Montana",10689,9994,9552,8080,8099,2590
1566,30011,"Carter County, Montana",1305,1289,1360,1503,1799,-494
1567,30013,"Cascade County, Montana",81576,80562,80357,77691,80696,880
1568,30015,"Chouteau County, Montana",5731,5765,5970,5452,6092,-361
1569,30017,"Custer County, Montana",11563,11548,11696,11697,13109,-1546
1570,30019,"Daniels County, Montana",1705,1649,2017,2266,2835,-1130
1571,30021,"Dawson County, Montana",8824,8933,9059,9505,11805,-2981
1572,30023,"Deer Lodge County, Montana",9153,9270,9417,10278,12518,-3365
1573,30025,"Fallon County, Montana",2975,2813,2837,3103,3763,-788
1574,30027,"Fergus County, Montana",11167,11513,11893,12083,13076,-1909
1575,30029,"Flathead County, Montana",102001,89215,74471,59218,51966,50035
1576,30031,"Gallatin County, Montana",111401,87676,67831,50463,42865,68536
1577,30033,"Garfield County, Montana",1051,1224,1279,1589,1656,-605
1578,30035,"Glacier County, Montana",13706,13251,13247,12121,10628,3078
1579,30037,"Golden Valley County, Montana",814,810,1042,912,1026,-212
1580,30039,"Granite County, Montana",3325,3044,2830,2548,2700,625
1581,30041,"Hill County, Montana",16422,16007,16673,17654,17985,-1563
1582,30043,"Jefferson County, Montana",12069,11166,10049,7939,7029,5040
1583,30045,"Judith Basin County, Montana",1968,1967,2329,2282,2646,-678
1584,30047,"Lake County, Montana",30383,28493,26507,21041,19056,11327
1585,30049,"Lewis And Clark County, Montana",68714,61643,55716,47495,43039,25675
1586,30051,"Liberty County, Montana",2455,2261,2158,2295,2329,126
1587,30053,"Lincoln County, Montana",19845,19507,18837,17481,17752,2093
1588,30055,"Mccone County, Montana",1826,1714,1977,2276,2702,-876
1589,30057,"Madison County, Montana",8530,7588,6851,5989,5448,3082
1590,30059,"Meagher County, Montana",1795,2024,1932,1819,2154,-359
1591,30061,"Mineral County, Montana",4330,4193,3884,3315,3675,655
1592,30063,"Missoula County, Montana",119062,107288,95802,78687,76016,43046
1593,30065,"Musselshell County, Montana",4682,4339,4497,4106,4428,254
1594,30067,"Park County, Montana",16513,15752,15694,14562,12660,3853
1595,30069,"Petroleum County, Montana",464,598,493,519,655,-191
1596,30071,"Phillips County, Montana",4032,4206,4601,5163,5367,-1335
1597,30073,"Pondera County, Montana",5911,6145,6424,6433,6731,-820
1598,30075,"Powder River County, Montana",1634,1659,1858,2090,2520,-886
1599,30077,"Powell County, Montana",6843,7077,7180,6620,6958,-115
1600,30079,"Prairie County, Montana",1162,1089,1199,1383,1836,-674
1601,30081,"Ravalli County, Montana",43424,40013,36070,25010,22493,20931
1602,30083,"Richland County, Montana",11097,9498,9667,10716,12243,-1146
1603,30085,"Roosevelt County, Montana",11091,10273,10620,10999,10467,624
1604,30087,"Rosebud County, Montana",9065,9134,9383,10505,9899,-834
1605,30089,"Sanders County, Montana",11804,11366,10227,8669,8675,3129
1606,30091,"Sheridan County, Montana",3389,3505,4105,4732,5414,-2025
1607,30093,"Silver Bow County, Montana",34895,33797,34606,33941,38092,-3197
1608,30095,"Stillwater County, Montana",9562,8934,8195,6536,5598,3964
1609,30097,"Sweet Grass County, Montana",3676,3717,3609,3154,3216,460
1610,30099,"Teton County, Montana",6127,6105,6445,6271,6491,-364
1611,30101,"Toole County, Montana",4812,5143,5267,5046,5559,-747
1612,30103,"Treasure County, Montana",614,848,861,874,981,-367
1613,30105,"Valley County, Montana",7424,7345,7675,8239,10250,-2826
1614,30107,"Wheatland County, Montana",2138,2118,2259,2246,2359,-221
1615,30109,"Wibaux County, Montana",1037,1067,1068,1191,1476,-439
1616,30111,"Yellowstone County, Montana",160390,144050,129352,113419,108035,52355
1617,31001,"Adams County, Nebraska",31541,31126,31151,29625,30656,885
1618,31003,"Antelope County, Nebraska",6315,6742,7452,7965,8675,-2360
1619,31005,"Arthur County, Nebraska",439,426,444,462,513,-74
1620,31007,"Banner County, Nebraska",645,720,819,852,918,-273
1621,31009,"Blaine County, Nebraska",467,539,583,675,867,-400
1622,31011,"Boone County, Nebraska",5228,5553,6259,6667,7391,-2163
1623,31013,"Box Butte County, Nebraska",10845,11372,12158,13130,13696,-2851
1624,31015,"Boyd County, Nebraska",1882,2107,2438,2835,3331,-1449
1625,31017,"Brown County, Nebraska",2887,3192,3525,3657,4377,-1490
1626,31019,"Buffalo County, Nebraska",49594,45437,42259,37447,34797,14797
1627,31021,"Burt County, Nebraska",6503,6964,7791,7868,8813,-2310
1628,31023,"Butler County, Nebraska",7997,8382,8767,8601,9330,-1333
1629,31025,"Cass County, Nebraska",26022,25246,24334,21318,20297,5725
1630,31027,"Cedar County, Nebraska",8483,8906,9615,10131,11375,-2892
1631,31029,"Chase County, Nebraska",3707,3927,4068,4381,4758,-1051
1632,31031,"Cherry County, Nebraska",5801,5783,6148,6307,6758,-957
1633,31033,"Cheyenne County, Nebraska",9428,10049,9830,9494,10057,-629
1634,31035,"Clay County, Nebraska",6193,6554,7039,7123,8106,-1913
1635,31037,"Colfax County, Nebraska",10681,10201,10441,9139,9890,791
1636,31039,"Cuming County, Nebraska",8882,9243,10203,10117,11664,-2782
1637,31041,"Custer County, Nebraska",10788,11001,11793,12270,13877,-3089
1638,31043,"Dakota County, Nebraska",20124,20674,20253,16742,16573,3551
1639,31045,"Dawes County, Nebraska",8685,9149,9060,9021,9609,-924
1640,31047,"Dawson County, Nebraska",23638,24245,24365,19940,22304,1334
1641,31049,"Deuel County, Nebraska",1770,1963,2098,2237,2462,-692
1642,31051,"Dixon County, Nebraska",5682,6000,6339,6143,7137,-1455
1643,31053,"Dodge County, Nebraska",36565,36621,36160,34500,35847,718
1644,31055,"Douglas County, Nebraska",565739,505545,463585,416444,397038,168701
1645,31057,"Dundy County, Nebraska",1928,1963,2292,2582,2861,-933
1646,31059,"Fillmore County, Nebraska",5542,5953,6634,7103,7920,-2378
1647,31061,"Franklin County, Nebraska",2970,3229,3574,3938,4377,-1407
1648,31063,"Frontier County, Nebraska",2636,2808,3099,3101,3647,-1011
1649,31065,"Furnas County, Nebraska",4712,4942,5324,5553,6486,-1774
1650,31067,"Gage County, Nebraska",21548,22591,22993,22794,24456,-2908
1651,31069,"Garden County, Nebraska",1916,2060,2292,2460,2802,-886
1652,31071,"Garfield County, Nebraska",2081,2081,1902,2141,2363,-282
1653,31073,"Gosper County, Nebraska",2001,2058,2143,1928,2140,-139
1654,31075,"Grant County, Nebraska",691,661,747,769,877,-186
1655,31077,"Greeley County, Nebraska",2361,2542,2714,3006,3462,-1101
1656,31079,"Hall County, Nebraska",61338,56899,53534,48925,47690,13648
1657,31081,"Hamilton County, Nebraska",9219,9160,9403,8862,9301,-82
1658,31083,"Harlan County, Nebraska",3380,3460,3786,3810,4292,-912
1659,31085,"Hayes County, Nebraska",889,1025,1068,1222,1356,-467
1660,31087,"Hitchcock County, Nebraska",2788,2925,3111,3750,4079,-1291
1661,31089,"Holt County, Nebraska",10123,10479,11551,12599,13552,-3429
1662,31091,"Hooker County, Nebraska",741,690,783,793,990,-249
1663,31093,"Howard County, Nebraska",6428,6302,6567,6055,6773,-345
1664,31095,"Jefferson County, Nebraska",7102,7708,8333,8759,9817,-2715
1665,31097,"Johnson County, Nebraska",5118,5211,4488,4673,5285,-167
1666,31099,"Kearney County, Nebraska",6588,6552,6882,6629,7053,-465
1667,31101,"Keith County, Nebraska",8048,8356,8875,8584,9364,-1316
1668,31103,"Keya Paha County, Nebraska",875,740,983,1029,1301,-426
1669,31105,"Kimball County, Nebraska",3576,3814,4089,4108,4882,-1306
1670,31107,"Knox County, Nebraska",8400,8762,9374,9534,11457,-3057
1671,31109,"Lancaster County, Nebraska",315976,279428,250291,213641,192884,123092
1672,31111,"Lincoln County, Nebraska",35042,36167,34632,32508,36455,-1413
1673,31113,"Logan County, Nebraska",896,682,774,878,983,-87
1674,31115,"Loup County, Nebraska",690,635,712,683,859,-169
1675,31117,"Mcpherson County, Nebraska",420,489,533,546,593,-173
1676,31119,"Madison County, Nebraska",35023,34720,35226,32655,31382,3641
1677,31121,"Merrick County, Nebraska",7826,7784,8204,8042,8945,-1119
1678,31123,"Morrill County, Nebraska",4711,5071,5440,5423,6085,-1374
1679,31125,"Nance County, Nebraska",3525,3755,4038,4275,4740,-1215
1680,31127,"Nemaha County, Nebraska",6978,7249,7576,7980,8367,-1389
1681,31129,"Nuckolls County, Nebraska",4204,4583,5057,5786,6726,-2522
1682,31131,"Otoe County, Nebraska",15965,15741,15396,14252,15183,782
1683,31133,"Pawnee County, Nebraska",2640,2767,3087,3317,3937,-1297
1684,31135,"Perkins County, Nebraska",2889,2983,3200,3367,3637,-748
1685,31137,"Phelps County, Nebraska",9050,9234,9747,9715,9769,-719
1686,31139,"Pierce County, Nebraska",7132,7308,7857,7827,8481,-1349
1687,31141,"Platte County, Nebraska",33250,31675,31662,29820,28852,4398
1688,31143,"Polk County, Nebraska",5208,5412,5639,5675,6320,-1112
1689,31145,"Red Willow County, Nebraska",10725,11069,11448,11705,12615,-1890
1690,31147,"Richardson County, Nebraska",7913,8455,9531,9937,11315,-3402
1691,31149,"Rock County, Nebraska",1430,1651,1756,2019,2383,-953
1692,31151,"Saline County, Nebraska",14221,14098,13843,12715,13131,1090
1693,31153,"Sarpy County, Nebraska",183956,152180,122595,102583,86015,97941
1694,31155,"Saunders County, Nebraska",21356,20543,19830,18285,18716,2640
1695,31157,"Scotts Bluff County, Nebraska",35884,36569,36951,36025,38344,-2460
1696,31159,"Seward County, Nebraska",17217,16628,16496,15450,15789,1428
1697,31161,"Sheridan County, Nebraska",5215,5538,6198,6750,7544,-2329
1698,31163,"Sherman County, Nebraska",3015,3144,3318,3718,4226,-1211
1699,31165,"Sioux County, Nebraska",1298,1340,1475,1549,1845,-547
1700,31167,"Stanton County, Nebraska",5946,6207,6455,6244,6549,-603
1701,31169,"Thayer County, Nebraska",5000,5262,6055,6635,7582,-2582
1702,31171,"Thomas County, Nebraska",586,756,729,851,973,-387
1703,31173,"Thurston County, Nebraska",7218,6907,7171,6936,7186,32
1704,31175,"Valley County, Nebraska",4100,4284,4647,5169,5633,-1533
1705,31177,"Washington County, Nebraska",20546,20148,18780,16607,15508,5038
1706,31179,"Wayne County, Nebraska",9388,9573,9851,9364,9858,-470
1707,31181,"Webster County, Nebraska",3497,3815,4061,4279,4858,-1361
1708,31183,"Wheeler County, Nebraska",689,751,886,948,1060,-371
1709,31185,"York County, Nebraska",13671,13886,14598,14428,14798,-1127
1710,32001,"Churchill County, Nevada",24606,24946,23982,17938,13917,10689
1711,32003,"Clark County, Nevada",2228866,1895521,1375765,741459,463087,1765779
1712,32005,"Douglas County, Nevada",48486,47042,41259,27637,19421,29065
1713,32007,"Elko County, Nevada",52537,47707,45291,33530,17269,35268
1714,32009,"Esmeralda County, Nevada",1030,892,971,1344,777,253
1715,32011,"Eureka County, Nevada",1839,1724,1651,1547,1198,641
1716,32013,"Humboldt County, Nevada",16834,15986,16106,12844,9434,7400
1717,32015,"Lander County, Nevada",5565,5545,5794,6266,4076,1489
1718,32017,"Lincoln County, Nevada",5177,5060,4165,3775,3732,1445
1719,32019,"Lyon County, Nevada",55667,51515,34501,20001,13594,42073
1720,32021,"Mineral County, Nevada",4487,4812,5071,6475,6217,-1730
1721,32023,"Nye County, Nevada",45514,43878,32485,17781,9048,36466
1722,32027,"Pershing County, Nevada",6591,6703,6693,4336,3408,3183
1723,32029,"Storey County, Nevada",4086,4016,3399,2526,1503,2583
1724,32031,"Washoe County, Nevada",464182,412844,339486,254667,193623,270559
1725,32033,"White Pine County, Nevada",9570,9765,9181,9264,8167,1403
1726,32510,"Carson City, Nevada",55244,55375,52457,40443,32022,23222
1727,33001,"Belknap County, New Hampshire",61174,60142,56325,49216,42884,18290
1728,33003,"Carroll County, New Hampshire",48461,47772,43666,35410,27931,20530
1729,33005,"Cheshire County, New Hampshire",76040,77445,73825,70121,62116,13924
1730,33007,"Coos County, New Hampshire",31486,33445,33111,34828,35147,-3661
1731,33009,"Grafton County, New Hampshire",90331,88356,81743,74929,65806,24525
1732,33011,"Hillsborough County, New Hampshire",415305,399555,380841,336073,276608,138697
1733,33013,"Merrimack County, New Hampshire",150902,146785,136225,120005,98302,52600
1734,33015,"Rockingham County, New Hampshire",308211,294638,277359,245845,190345,117866
1735,33017,"Strafford County, New Hampshire",130161,122158,112233,104233,85408,44753
1736,33019,"Sullivan County, New Hampshire",43173,43643,40458,38592,36063,7110
1737,34001,"Atlantic County, New Jersey",264650,273162,252552,224327,194119,70531
1738,34003,"Bergen County, New Jersey",931275,896482,884118,825380,845385,85890
1739,34005,"Burlington County, New Jersey",446301,447861,423394,395066,362542,83759
1740,34007,"Camden County, New Jersey",506721,513574,508932,502824,471650,35071
1741,34009,"Cape May County, New Jersey",92701,97684,102326,95089,82266,10435
1742,34011,"Cumberland County, New Jersey",150085,155456,146438,138053,132866,17219
1743,34013,"Essex County, New Jersey",798698,780872,793633,778206,851116,-52418
1744,34015,"Gloucester County, New Jersey",291745,285223,254673,230082,199917,91828
1745,34017,"Hudson County, New Jersey",671923,622123,608975,553099,556972,114951
1746,34019,"Hunterdon County, New Jersey",125063,128458,121989,107776,87361,37702
1747,34021,"Mercer County, New Jersey",368085,364445,350761,325824,307863,60222
1748,34023,"Middlesex County, New Jersey",825015,798882,750162,671780,595893,229122
1749,34025,"Monmouth County, New Jersey",620821,628112,615301,553124,503173,117648
1750,34027,"Morris County, New Jersey",492715,489811,470212,421353,407630,85085
1751,34029,"Ocean County, New Jersey",602018,569374,510916,433203,346038,255980
1752,34031,"Passaic County, New Jersey",502763,496204,489049,453060,447585,55178
1753,34033,"Salem County, New Jersey",62754,65982,64285,65294,64676,-1922
1754,34035,"Somerset County, New Jersey",330151,319347,297490,240279,203129,127022
1755,34037,"Sussex County, New Jersey",140996,149996,144166,130943,116119,24877
1756,34039,"Union County, New Jersey",555208,529547,522541,493819,504094,51114
1757,34041,"Warren County, New Jersey",105730,108982,102437,91607,84429,21301
1758,35001,"Bernalillo County, New Mexico",679037,646881,556678,480577,419700,259337
1759,35003,"Catron County, New Mexico",3547,3652,3543,2563,2720,827
1760,35005,"Chaves County, New Mexico",64912,64268,61382,57849,51103,13809
1761,35007,"Colfax County, New Mexico",12106,13827,14189,12925,13667,-1561
1762,35009,"Curry County, New Mexico",49502,46924,45044,42207,42019,7483
1763,35011,"De Baca County, New Mexico",1995,1772,2240,2252,2454,-459
1764,35013,"Dona Ana County, New Mexico",217696,201670,174682,135510,96340,121356
1765,35015,"Eddy County, New Mexico",57865,52665,51658,48605,47855,10010
1766,35017,"Grant County, New Mexico",27391,29706,31002,27676,26204,1187
1767,35019,"Guadalupe County, New Mexico",4336,4698,4680,4156,4496,-160
1768,35021,"Harding County, New Mexico",432,943,810,987,1090,-658
1769,35023,"Hidalgo County, New Mexico",4234,4964,5932,5958,6049,-1815
1770,35025,"Lea County, New Mexico",70359,62503,55511,55765,55993,14366
1771,35027,"Lincoln County, New Mexico",19640,20502,19411,12219,10997,8643
1772,35028,"Los Alamos County, New Mexico",18976,18091,18343,18115,17599,1377
1773,35029,"Luna County, New Mexico",24022,25252,25016,18110,15585,8437
1774,35031,"Mckinley County, New Mexico",71956,70663,74798,60686,56449,15507
1775,35033,"Mora County, New Mexico",4500,4923,5180,4264,4205,295
1776,35035,"Otero County, New Mexico",66804,62782,62298,51928,44665,22139
1777,35037,"Quay County, New Mexico",8265,9002,10155,10823,10577,-2312
1778,35039,"Rio Arriba County, New Mexico",38962,40195,41190,34365,29282,9680
1779,35041,"Roosevelt County, New Mexico",18723,19372,18018,16702,15695,3028
1780,35043,"Sandoval County, New Mexico",144954,124263,89908,63319,34799,110155
1781,35045,"San Juan County, New Mexico",125608,127517,113801,91605,81433,44175
1782,35047,"San Miguel County, New Mexico",27546,29321,30126,25743,22751,4795
1783,35049,"Santa Fe County, New Mexico",150319,141702,129292,98928,75360,74959
1784,35051,"Sierra County, New Mexico",10988,11938,13270,9912,8454,2534
1785,35053,"Socorro County, New Mexico",16723,17964,18078,14764,12566,4157
1786,35055,"Taos County, New Mexico",32759,32574,29979,23118,19456,13303
1787,35057,"Torrance County, New Mexico",15477,16467,16911,10285,7491,7986
1788,35059,"Union County, New Mexico",4106,4388,4174,4124,4725,-619
1789,35061,"Valencia County, New Mexico",76518,74554,66152,45235,61115,15403
1790,36001,"Albany County, New York",306165,304032,294565,292594,285909,20256
1791,36003,"Allegany County, New York",46304,49105,49927,50470,51742,-5438
1792,36005,"Bronx County, New York",1427056,1365725,1332650,1203789,1168972,258084
1793,36007,"Broome County, New York",192042,200804,200536,212160,213648,-21606
1794,36009,"Cattaraugus County, New York",76750,80776,83955,84234,85697,-8947
1795,36011,"Cayuga County, New York",76958,80431,81963,82313,79894,-2936
1796,36013,"Chautauqua County, New York",127584,135263,139750,141895,146925,-19341
1797,36015,"Chemung County, New York",84115,88708,91070,95195,97656,-13541
1798,36017,"Chenango County, New York",47527,51045,51401,51768,49344,-1817
1799,36019,"Clinton County, New York",80320,82380,79894,85969,80750,-430
1800,36021,"Columbia County, New York",60016,63241,63094,62982,59487,529
1801,36023,"Cortland County, New York",47618,49452,48599,48963,48820,-1202
1802,36025,"Delaware County, New York",44676,48220,48055,47225,46824,-2148
1803,36027,"Dutchess County, New York",293524,296152,280150,259462,245055,48469
1804,36029,"Erie County, New York",918873,921202,950265,968532,1015472,-96599
1805,36031,"Essex County, New York",37281,39416,38851,37152,36176,1105
1806,36033,"Franklin County, New York",50389,51697,51134,46540,44929,5460
1807,36035,"Fulton County, New York",53452,55497,55073,54191,55153,-1701
1808,36037,"Genesee County, New York",57554,59952,60370,60060,59400,-1846
1809,36039,"Greene County, New York",47335,49410,48195,44739,40861,6474
1810,36041,"Hamilton County, New York",4454,4908,5379,5279,5034,-580
1811,36043,"Herkimer County, New York",61738,64332,64427,65797,66714,-4976
1812,36045,"Jefferson County, New York",111454,115069,111738,110943,88151,23303
1813,36047,"Kings County, New York",2576771,2466782,2465326,2300664,2230936,345835
1814,36049,"Lewis County, New York",26456,27017,26944,26796,25035,1421
1815,36051,"Livingston County, New York",63218,65441,64328,62372,57006,6212
1816,36053,"Madison County, New York",70990,72887,69441,69120,65150,5840
1817,36055,"Monroe County, New York",743084,741274,735343,713968,702238,40846
1818,36057,"Montgomery County, New York",49294,49945,49708,51981,53439,-4145
1819,36059,"Nassau County, New York",1355683,1329083,1334544,1287348,1321582,34101
1820,36061,"New York County, New York",1629153,1583345,1537195,1487536,1428285,200868
1821,36063,"Niagara County, New York",210145,216064,219846,220756,227354,-17209
1822,36065,"Oneida County, New York",229074,234533,235469,250836,253466,-24392
1823,36067,"Onondaga County, New York",461591,463704,458336,468973,463920,-2329
1824,36069,"Ontario County, New York",109774,106298,100224,95101,88909,20865
1825,36071,"Orange County, New York",382077,370201,341367,307647,259603,122474
1826,36073,"Orleans County, New York",40624,43169,44171,41846,38496,2128
1827,36075,"Oswego County, New York",117630,122220,122377,121771,113901,3729
1828,36077,"Otsego County, New York",59593,62604,61676,60517,59075,518
1829,36079,"Putnam County, New York",98714,99545,95745,83941,77193,21521
1830,36081,"Queens County, New York",2270976,2199169,2229379,1951598,1891325,379651
1831,36083,"Rensselaer County, New York",159013,158629,152538,154429,151966,7047
1832,36085,"Richmond County, New York",475596,463450,443728,378977,352121,123475
1833,36087,"Rockland County, New York",325213,305461,286753,265475,259530,65683
1834,36089,"St. Lawrence County, New York",108352,111778,111931,111974,114254,-5902
1835,36091,"Saratoga County, New York",229313,217264,200635,181276,153759,75554
1836,36093,"Schenectady County, New York",155086,153268,146555,149285,149946,5140
1837,36095,"Schoharie County, New York",31189,32789,31582,31859,29710,1479
1838,36097,"Schuyler County, New York",17845,18566,19224,18662,17686,159
1839,36099,"Seneca County, New York",34295,35309,33342,33683,33733,562
1840,36101,"Steuben County, New York",95843,98724,98726,99088,99217,-3374
1841,36103,"Suffolk County, New York",1481364,1482548,1419369,1321864,1284231,197133
1842,36105,"Sullivan County, New York",75329,77625,73966,69277,65155,10174
1843,36107,"Tioga County, New York",48431,51377,51784,52337,49812,-1381
1844,36109,"Tompkins County, New York",102237,100612,96501,94097,87085,15152
1845,36111,"Ulster County, New York",178371,182782,177749,165304,158158,20213
1846,36113,"Warren County, New York",64187,65707,63303,59209,54854,9333
1847,36115,"Washington County, New York",61304,63088,61042,59330,54795,6509
1848,36117,"Wayne County, New York",90103,93654,93765,89123,84581,5522
1849,36119,"Westchester County, New York",968738,939406,923459,874866,866599,102139
1850,36121,"Wyoming County, New York",40027,42367,43424,42507,39895,132
1851,36123,"Yates County, New York",24981,25250,24621,22810,21459,3522
1852,37001,"Alamance County, North Carolina",166144,147072,130800,108213,99319,66825
1853,37003,"Alexander County, North Carolina",37271,36797,33603,27544,24999,12272
1854,37005,"Alleghany County, North Carolina",11085,11084,10677,9590,9587,1498
1855,37007,"Anson County, North Carolina",24430,26785,25275,23474,25649,-1219
1856,37009,"Ashe County, North Carolina",27009,26787,24384,22209,22325,4684
1857,37011,"Avery County, North Carolina",17510,17951,17167,14867,14409,3101
1858,37013,"Beaufort County, North Carolina",47160,47185,44958,42283,40355,6805
1859,37015,"Bertie County, North Carolina",19081,20890,19773,20388,21024,-1943
1860,37017,"Bladen County, North Carolina",33209,34629,32278,28663,30491,2718
1861,37019,"Brunswick County, North Carolina",137303,101994,73143,50985,35777,101526
1862,37021,"Buncombe County, North Carolina",259576,233249,206330,174821,160934,98642
1863,37023,"Burke County, North Carolina",90148,90557,89148,75744,72504,17644
1864,37025,"Cabarrus County, North Carolina",211605,169990,131063,98935,85895,125710
1865,37027,"Caldwell County, North Carolina",82056,82162,77415,70709,67746,14310
1866,37029,"Camden County, North Carolina",10654,9719,6885,5904,5829,4825
1867,37031,"Carteret County, North Carolina",69301,65068,59383,52556,41092,28209
1868,37033,"Caswell County, North Carolina",22619,23848,23501,20693,20705,1914
1869,37035,"Catawba County, North Carolina",158507,153149,141685,118412,105208,53299
1870,37037,"Chatham County, North Carolina",72853,61426,49329,38759,33415,39438
1871,37039,"Cherokee County, North Carolina",28413,27317,24298,20170,18933,9480
1872,37041,"Chowan County, North Carolina",13995,14859,14526,13506,12558,1437
1873,37043,"Clay County, North Carolina",11150,10418,8775,7155,6619,4531
1874,37045,"Cleveland County, North Carolina",97765,97786,96287,84714,83435,14330
1875,37047,"Columbus County, North Carolina",55659,56856,54749,49587,51037,4622
1876,37049,"Craven County, North Carolina",102290,100001,91436,81613,71043,31247
1877,37051,"Cumberland County, North Carolina",334562,312994,302963,274566,247160,87402
1878,37053,"Currituck County, North Carolina",27210,23299,18190,13736,11089,16121
1879,37055,"Dare County, North Carolina",36698,33650,29967,22746,13377,23321
1880,37057,"Davidson County, North Carolina",166837,160638,147246,126677,113162,53675
1881,37059,"Davie County, North Carolina",42543,40581,34835,27859,24599,17944
1882,37061,"Duplin County, North Carolina",58965,56657,49063,39995,40952,18013
1883,37063,"Durham County, North Carolina",317665,258578,223314,181835,152785,164880
1884,37065,"Edgecombe County, North Carolina",52069,56247,55606,56558,55988,-3919
1885,37067,"Forsyth County, North Carolina",378499,342989,306067,265878,243683,134816
1886,37069,"Franklin County, North Carolina",68027,58473,47260,36414,30055,37972
1887,37071,"Gaston County, North Carolina",222119,202642,190365,175093,162568,59551
1888,37073,"Gates County, North Carolina",11519,12039,10516,9305,8875,2644
1889,37075,"Graham County, North Carolina",8501,8702,7993,7196,7217,1284
1890,37077,"Granville County, North Carolina",59823,58071,48498,38345,34043,25780
1891,37079,"Greene County, North Carolina",20987,21157,18974,15384,16117,4870
1892,37081,"Guilford County, North Carolina",532956,475786,421048,347420,317154,215802
1893,37083,"Halifax County, North Carolina",50678,55293,57370,55516,55286,-4608
1894,37085,"Harnett County, North Carolina",134328,109031,91025,67822,59570,74758
1895,37087,"Haywood County, North Carolina",61862,58597,54033,46942,46495,15367
1896,37089,"Henderson County, North Carolina",116298,103881,89173,69285,58580,57718
1897,37091,"Hertford County, North Carolina",23752,24384,22601,22523,23368,384
1898,37093,"Hoke County, North Carolina",54590,44128,33646,22856,20383,34207
1899,37095,"Hyde County, North Carolina",5089,5721,5826,5411,5873,-784
1900,37097,"Iredell County, North Carolina",178853,154632,122660,92931,82538,96315
1901,37099,"Jackson County, North Carolina",43435,39144,33121,26846,25811,17624
1902,37101,"Johnston County, North Carolina",203308,160675,121965,81306,70599,132709
1903,37103,"Jones County, North Carolina",9453,10060,10381,9414,9705,-252
1904,37105,"Lee County, North Carolina",61083,55576,49040,41374,36718,24365
1905,37107,"Lenoir County, North Carolina",56350,59307,59648,57274,59819,-3469
1906,37109,"Lincoln County, North Carolina",84580,75697,63780,50319,42372,42208
1907,37111,"Mcdowell County, North Carolina",45402,44593,42151,35681,35135,10267
1908,37113,"Macon County, North Carolina",35172,33453,29811,23499,20178,14994
1909,37115,"Madison County, North Carolina",21608,20549,19635,16953,16827,4781
1910,37117,"Martin County, North Carolina",22644,24471,25593,25078,25948,-3304
1911,37119,"Mecklenburg County, North Carolina",1095170,882761,695454,511433,404270,690900
1912,37121,"Mitchell County, North Carolina",14959,15680,15687,14433,14428,531
1913,37123,"Montgomery County, North Carolina",27223,27611,26822,23346,22469,4754
1914,37125,"Moore County, North Carolina",99263,85914,74769,59013,50505,48758
1915,37127,"Nash County, North Carolina",94287,94402,87420,76677,67153,27134
1916,37129,"New Hanover County, North Carolina",231448,197272,160307,120284,103471,127977
1917,37131,"Northampton County, North Carolina",19672,22161,22086,20798,22584,-2912
1918,37133,"Onslow County, North Carolina",198377,169207,150355,149838,112784,85593
1919,37135,"Orange County, North Carolina",146354,129562,118227,93851,77055,69299
1920,37137,"Pamlico County, North Carolina",12673,13072,12934,11372,10398,2275
1921,37139,"Pasquotank County, North Carolina",39775,40167,34897,31298,28462,11313
1922,37141,"Pender County, North Carolina",61891,50256,41082,28855,22215,39676
1923,37143,"Perquimans County, North Carolina",13513,13091,11368,10447,9486,4027
1924,37145,"Person County, North Carolina",39561,38942,35623,30180,29164,10397
1925,37147,"Pitt County, North Carolina",179961,161385,133798,107924,90146,89815
1926,37149,"Polk County, North Carolina",20682,20289,18324,14416,12984,7698
1927,37151,"Randolph County, North Carolina",143460,140034,130454,106546,91728,51732
1928,37153,"Richmond County, North Carolina",44759,46477,46564,44518,45481,-722
1929,37155,"Robeson County, North Carolina",131656,131708,123339,105179,101610,30046
1930,37157,"Rockingham County, North Carolina",91051,93322,91928,86064,83426,7625
1931,37159,"Rowan County, North Carolina",140978,136880,130340,110605,99186,41792
1932,37161,"Rutherford County, North Carolina",66741,66928,62899,56918,53787,12954
1933,37163,"Sampson County, North Carolina",63284,62832,60161,47297,49687,13597
1934,37165,"Scotland County, North Carolina",34921,36325,35998,33754,32273,2648
1935,37167,"Stanly County, North Carolina",62050,60109,58100,51765,48517,13533
1936,37169,"Stokes County, North Carolina",45688,47194,44711,37223,33086,12602
1937,37171,"Surry County, North Carolina",71904,73287,71219,61704,59449,12455
1938,37173,"Swain County, North Carolina",14241,13861,12968,11268,10283,3958
1939,37175,"Transylvania County, North Carolina",34039,32404,29334,25520,23417,10622
1940,37177,"Tyrrell County, North Carolina",3978,4374,4149,3856,3975,3
1941,37179,"Union County, North Carolina",235767,190346,123677,84211,70380,165387
1942,37181,"Vance County, North Carolina",44614,44975,42954,38892,36748,7866
1943,37183,"Wake County, North Carolina",1091662,850546,627846,423380,301327,790335
1944,37185,"Warren County, North Carolina",19746,20810,19972,17265,16232,3514
1945,37187,"Washington County, North Carolina",11788,13248,13723,13997,14801,-3013
1946,37189,"Watauga County, North Carolina",55669,49705,42695,36952,31666,24003
1947,37191,"Wayne County, North Carolina",123785,120102,113329,104666,97054,26731
1948,37193,"Wilkes County, North Carolina",68341,69063,65632,59393,58657,9684
1949,37195,"Wilson County, North Carolina",81579,79533,73814,66061,63132,18447
1950,37197,"Yadkin County, North Carolina",37589,38158,36348,30488,28439,9150
1951,37199,"Yancey County, North Carolina",17870,17911,17774,15419,14934,2936
1952,38001,"Adams County, North Dakota",2271,2348,2593,3174,3584,-1313
1953,38003,"Barnes County, North Dakota",10592,11056,11775,12545,13960,-3368
1954,38005,"Benson County, North Dakota",6860,6662,6964,7198,7944,-1084
1955,38007,"Billings County, North Dakota",886,897,888,1108,1138,-252
1956,38009,"Bottineau County, North Dakota",6418,6430,7149,8011,9239,-2821
1957,38011,"Bowman County, North Dakota",3091,3102,3242,3596,4229,-1138
1958,38013,"Burke County, North Dakota",2142,1948,2242,3002,3822,-1680
1959,38015,"Burleigh County, North Dakota",95509,78776,69416,60131,54811,40698
1960,38017,"Cass County, North Dakota",179937,144410,123138,102874,88247,91690
1961,38019,"Cavalier County, North Dakota",3769,4046,4831,6064,7636,-3867
1962,38021,"Dickey County, North Dakota",4857,5340,5757,6107,7207,-2350
1963,38023,"Divide County, North Dakota",2289,2050,2283,2899,3494,-1205
1964,38025,"Dunn County, North Dakota",4362,3477,3600,4005,4627,-265
1965,38027,"Eddy County, North Dakota",2262,2455,2757,2951,3554,-1292
1966,38029,"Emmons County, North Dakota",3262,3617,4331,4830,5877,-2615
1967,38031,"Foster County, North Dakota",3231,3434,3759,3983,4611,-1380
1968,38033,"Golden Valley County, North Dakota",1796,1539,1924,2108,2391,-595
1969,38035,"Grand Forks County, North Dakota",70243,66771,66109,70683,66100,4143
1970,38037,"Grant County, North Dakota",2318,2486,2841,3549,4274,-1956
1971,38039,"Griggs County, North Dakota",2314,2426,2754,3303,3714,-1400
1972,38041,"Hettinger County, North Dakota",2510,2506,2715,3445,4275,-1765
1973,38043,"Kidder County, North Dakota",2468,2521,2753,3332,3833,-1365
1974,38045,"La Moure County, North Dakota",4225,4233,4701,5383,6473,-2248
1975,38047,"Logan County, North Dakota",1743,2001,2308,2847,3493,-1750
1976,38049,"Mchenry County, North Dakota",5825,5400,5987,6528,7858,-2033
1977,38051,"Mcintosh County, North Dakota",2535,2917,3390,4021,4800,-2265
1978,38053,"Mckenzie County, North Dakota",13836,6004,5737,6383,7132,6704
1979,38055,"Mclean County, North Dakota",9531,8861,9311,10457,12383,-2852
1980,38057,"Mercer County, North Dakota",8359,8353,8644,9808,9404,-1045
1981,38059,"Morton County, North Dakota",31118,26712,25303,23700,25177,5941
1982,38061,"Mountrail County, North Dakota",10348,7228,6631,7021,7679,2669
1983,38063,"Nelson County, North Dakota",2864,3185,3715,4410,5233,-2369
1984,38065,"Oliver County, North Dakota",1962,1808,2065,2381,2495,-533
1985,38067,"Pembina County, North Dakota",6850,7530,8585,9238,10399,-3549
1986,38069,"Pierce County, North Dakota",4061,4364,4675,5052,6166,-2105
1987,38071,"Ramsey County, North Dakota",11521,11371,12066,12681,13048,-1527
1988,38073,"Ransom County, North Dakota",5258,5624,5890,5921,6698,-1440
1989,38075,"Renville County, North Dakota",2387,2442,2610,3160,3608,-1221
1990,38077,"Richland County, North Dakota",16245,16507,17998,18148,19207,-2962
1991,38079,"Rolette County, North Dakota",14437,13766,13674,12772,12177,2260
1992,38081,"Sargent County, North Dakota",3899,3971,4366,4549,5512,-1613
1993,38083,"Sheridan County, North Dakota",1289,1293,1710,2148,2819,-1530
1994,38085,"Sioux County, North Dakota",4339,4121,4044,3761,3620,719
1995,38087,"Slope County, North Dakota",788,727,767,907,1157,-369
1996,38089,"Stark County, North Dakota",31164,23486,22636,22832,23697,7467
1997,38091,"Steele County, North Dakota",1817,1977,2258,2420,3106,-1289
1998,38093,"Stutsman County, North Dakota",20879,20984,21908,22241,24154,-3275
1999,38095,"Towner County, North Dakota",2191,2289,2876,3627,4052,-1861
2000,38097,"Traill County, North Dakota",7999,8190,8477,8752,9624,-1625
2001,38099,"Walsh County, North Dakota",10642,11286,12389,13840,15371,-4729
2002,38101,"Ward County, North Dakota",68962,59461,58795,57921,58392,10570
2003,38103,"Wells County, North Dakota",3889,4276,5102,5864,6979,-3090
2004,38105,"Williams County, North Dakota",36044,21194,19761,21129,22237,13807
2005,39001,"Adams County, Ohio",27685,28578,27330,25371,24328,3357
2006,39003,"Allen County, Ohio",102808,106586,108473,109755,112241,-9433
2007,39005,"Ashland County, Ohio",53533,53341,52523,47507,46178,7355
2008,39007,"Ashtabula County, Ohio",97416,101867,102728,99821,104215,-6799
2009,39009,"Athens County, Ohio",65945,64455,62223,59549,56399,9546
2010,39011,"Auglaize County, Ohio",45709,46023,46611,44585,42554,3155
2011,39013,"Belmont County, Ohio",67424,70403,70226,71074,82569,-15145
2012,39015,"Brown County, Ohio",43508,44618,42285,34966,31920,11588
2013,39017,"Butler County, Ohio",382129,363465,332807,291479,258787,123342
2014,39019,"Carroll County, Ohio",27195,28988,28836,26521,25598,1597
2015,39021,"Champaign County, Ohio",38861,40140,38890,36019,33649,5212
2016,39023,"Clark County, Ohio",134409,139374,144742,147548,150236,-15827
2017,39025,"Clermont County, Ohio",205616,195312,177977,150187,128483,77133
2018,39027,"Clinton County, Ohio",42000,42416,40543,35415,34603,7397
2019,39029,"Columbiana County, Ohio",102514,108609,112075,108276,113572,-11058
2020,39031,"Coshocton County, Ohio",36558,37046,36655,35427,36024,534
2021,39033,"Crawford County, Ohio",41603,44294,46966,47870,50075,-8472
2022,39035,"Cuyahoga County, Ohio",1241475,1293825,1393978,1412140,1498400,-256925
2023,39037,"Darke County, Ohio",51387,52945,53309,53619,55096,-3709
2024,39039,"Defiance County, Ohio",38024,39119,39500,39350,39987,-1963
2025,39041,"Delaware County, Ohio",205454,166108,109989,66929,53840,151614
2026,39043,"Erie County, Ohio",74419,77454,79551,76779,79655,-5236
2027,39045,"Fairfield County, Ohio",156204,143949,122759,103461,93678,62526
2028,39047,"Fayette County, Ohio",28609,28913,28433,27466,27467,1142
2029,39049,"Franklin County, Ohio",1304715,1141117,1068978,961437,869132,435583
2030,39051,"Fulton County, Ohio",42186,42756,42084,38498,37751,4435
2031,39053,"Gallia County, Ohio",29995,30943,31069,30954,30098,-103
2032,39055,"Geauga County, Ohio",93657,93604,90895,81129,74474,19183
2033,39057,"Greene County, Ohio",167867,159940,147886,136731,129769,38098
2034,39059,"Guernsey County, Ohio",38996,40351,40792,39024,42024,-3028
2035,39061,"Hamilton County, Ohio",815790,802194,845303,866228,873224,-57434
2036,39063,"Hancock County, Ohio",75765,74670,71295,65536,64581,11184
2037,39065,"Hardin County, Ohio",31393,32104,31945,31111,32719,-1326
2038,39067,"Harrison County, Ohio",15132,15867,15856,16085,18152,-3020
2039,39069,"Henry County, Ohio",27068,28546,29210,29108,28383,-1315
2040,39071,"Highland County, Ohio",43080,43648,40875,35728,33477,9603
2041,39073,"Hocking County, Ohio",28306,29338,28241,25533,24304,4002
2042,39075,"Holmes County, Ohio",43954,42068,38943,32849,29416,14538
2043,39077,"Huron County, Ohio",58271,59932,59487,56240,54608,3663
2044,39079,"Jackson County, Ohio",32440,33165,32641,30230,30592,1848
2045,39081,"Jefferson County, Ohio",65943,70041,73894,80298,91564,-25621
2046,39083,"Knox County, Ohio",61776,60201,54500,47473,46304,15472
2047,39085,"Lake County, Ohio",229755,229418,227511,215499,212801,16954
2048,39087,"Lawrence County, Ohio",59901,62647,62319,61834,63849,-3948
2049,39089,"Licking County, Ohio",175409,163708,145491,128300,120981,54428
2050,39091,"Logan County, Ohio",45315,46006,46005,42310,39155,6160
2051,39093,"Lorain County, Ohio",309134,299605,284664,271126,274909,34225
2052,39095,"Lucas County, Ohio",430319,444046,455054,462361,471741,-41422
2053,39097,"Madison County, Ohio",44248,42844,40213,37068,33004,11244
2054,39099,"Mahoning County, Ohio",228452,241899,257555,264806,289487,-61035
2055,39101,"Marion County, Ohio",65179,66530,66217,64274,67974,-2795
2056,39103,"Medina County, Ohio",179116,170137,151095,122354,113150,65966
2057,39105,"Meigs County, Ohio",22974,23649,23072,22987,23641,-667
2058,39107,"Mercer County, Ohio",41034,40958,40924,39443,38334,2700
2059,39109,"Miami County, Ohio",106074,102315,98868,93182,90381,15693
2060,39111,"Monroe County, Ohio",13827,14751,15180,15497,17382,-3555
2061,39113,"Montgomery County, Ohio",531988,538461,559062,573809,571697,-39709
2062,39115,"Morgan County, Ohio",14557,15113,14897,14194,14241,316
2063,39117,"Morrow County, Ohio",35148,34815,31628,27749,26480,8668
2064,39119,"Muskingum County, Ohio",86033,85951,84585,82068,83340,2693
2065,39121,"Noble County, Ohio",14410,14634,14058,11336,11310,3100
2066,39123,"Ottawa County, Ohio",40557,41553,40985,40029,40076,481
2067,39125,"Paulding County, Ohio",18742,19679,20293,20488,21302,-2560
2068,39127,"Perry County, Ohio",36076,35843,34078,31557,31032,5044
2069,39129,"Pickaway County, Ohio",58112,55128,52727,48255,43662,14450
2070,39131,"Pike County, Ohio",27914,28674,27695,24249,22802,5112
2071,39133,"Portage County, Ohio",162476,159943,152061,142585,135856,26620
2072,39135,"Preble County, Ohio",40995,42502,42337,40113,38223,2772
2073,39137,"Putnam County, Ohio",33836,34647,34726,33819,32991,845
2074,39139,"Richland County, Ohio",121043,125980,128852,126137,131205,-10162
2075,39141,"Ross County, Ohio",76816,77537,73345,69330,65004,11812
2076,39143,"Sandusky County, Ohio",58801,61284,61792,61963,63267,-4466
2077,39145,"Scioto County, Ohio",75441,78988,79195,80327,84545,-9104
2078,39147,"Seneca County, Ohio",55251,57091,58683,59733,61901,-6650
2079,39149,"Shelby County, Ohio",48610,49350,47910,44915,43089,5521
2080,39151,"Stark County, Ohio",371516,376346,378098,367585,378823,-7307
2081,39153,"Summit County, Ohio",540810,543150,542899,514990,524472,16338
2082,39155,"Trumbull County, Ohio",199144,212780,225116,227813,241863,-42719
2083,39157,"Tuscarawas County, Ohio",92165,92508,90914,84090,84614,7551
2084,39159,"Union County, Ohio",57871,50708,40909,31969,29536,28335
2085,39161,"Van Wert County, Ohio",28213,29029,29659,30464,30458,-2245
2086,39163,"Vinton County, Ohio",13045,13485,12806,11098,11584,1461
2087,39165,"Warren County, Ohio",232540,207790,158383,113909,99276,133264
2088,39167,"Washington County, Ohio",60217,62066,63251,62254,64266,-4049
2089,39169,"Wayne County, Ohio",116063,114438,111564,101461,97408,18655
2090,39171,"Williams County, Ohio",36760,38172,39188,36956,36369,391
2091,39173,"Wood County, Ohio",130662,125295,121065,113269,107372,23290
2092,39175,"Wyandot County, Ohio",21907,22665,22908,22254,22651,-744
2093,40001,"Adair County, Oklahoma",22171,22424,21038,18421,18575,3596
2094,40003,"Alfalfa County, Oklahoma",5791,5621,6105,6416,7077,-1286
2095,40005,"Atoka County, Oklahoma",13815,14140,13879,12778,12748,1067
2096,40007,"Beaver County, Oklahoma",5326,5564,5857,6023,6806,-1480
2097,40009,"Beckham County, Oklahoma",21860,21817,19799,18812,19243,2617
2098,40011,"Blaine County, Oklahoma",9521,11972,11976,11470,13443,-3922
2099,40013,"Bryan County, Oklahoma",47325,41195,36534,32089,30535,16790
2100,40015,"Caddo County, Oklahoma",29179,28951,30150,29550,30905,-1726
2101,40017,"Canadian County, Oklahoma",144610,109814,87697,74409,56452,88158
2102,40019,"Carter County, Oklahoma",48380,46993,45621,42919,43610,4770
2103,40021,"Cherokee County, Oklahoma",48871,46182,42521,34049,30684,18187
2104,40023,"Choctaw County, Oklahoma",14727,15190,15342,15302,17203,-2476
2105,40025,"Cimarron County, Oklahoma",2159,2503,3148,3301,3648,-1489
2106,40027,"Cleveland County, Oklahoma",282189,246831,208016,174253,133173,149016
2107,40029,"Coal County, Oklahoma",5577,5801,6031,5780,6041,-464
2108,40031,"Comanche County, Oklahoma",121374,119902,114996,111486,112456,8918
2109,40033,"Cotton County, Oklahoma",5783,6230,6614,6651,7338,-1555
2110,40035,"Craig County, Oklahoma",14274,14951,14950,14104,15014,-740
2111,40037,"Creek County, Oklahoma",71505,68914,67367,60915,59016,12489
2112,40039,"Custer County, Oklahoma",28929,26824,26142,26897,25995,2934
2113,40041,"Delaware County, Oklahoma",42741,41017,37077,28070,23946,18795
2114,40043,"Dewey County, Oklahoma",4885,4720,4743,5551,5922,-1037
2115,40045,"Ellis County, Oklahoma",3936,4041,4075,4497,5596,-1660
2116,40047,"Garfield County, Oklahoma",61555,59093,57813,56735,62820,-1265
2117,40049,"Garvin County, Oklahoma",27789,27462,27210,26605,27856,-67
2118,40051,"Grady County, Oklahoma",55315,51545,45516,41747,39490,15825
2119,40053,"Grant County, Oklahoma",4369,4579,5144,5689,6518,-2149
2120,40055,"Greer County, Oklahoma",5790,6182,6061,6559,7028,-1238
2121,40057,"Harmon County, Oklahoma",2663,2875,3283,3793,4519,-1856
2122,40059,"Harper County, Oklahoma",3730,3607,3562,4063,4715,-985
2123,40061,"Haskell County, Oklahoma",12688,12577,11792,10940,11010,1678
2124,40063,"Hughes County, Oklahoma",13265,13606,14154,13023,14338,-1073
2125,40065,"Jackson County, Oklahoma",24808,26386,28439,28764,30356,-5548
2126,40067,"Jefferson County, Oklahoma",6084,6435,6818,7010,8183,-2099
2127,40069,"Johnston County, Oklahoma",11028,10816,10513,10032,10356,672
2128,40071,"Kay County, Oklahoma",44074,46473,48080,48056,49852,-5778
2129,40073,"Kingfisher County, Oklahoma",15811,14776,13926,13212,14187,1624
2130,40075,"Kiowa County, Oklahoma",8816,9540,10227,11347,12711,-3895
2131,40077,"Latimer County, Oklahoma",10239,11015,10692,10333,9840,399
2132,40079,"Le Flore County, Oklahoma",49999,49822,48109,43270,40698,9301
2133,40081,"Lincoln County, Oklahoma",34936,33823,32080,29216,26601,8335
2134,40083,"Logan County, Oklahoma",47401,39777,33924,29011,26881,20520
2135,40085,"Love County, Oklahoma",10128,9306,8831,8157,7469,2659
2136,40087,"Mcclain County, Oklahoma",39921,33107,27740,22795,20291,19630
2137,40089,"Mccurtain County, Oklahoma",32913,33130,34402,33433,36151,-3238
2138,40091,"Mcintosh County, Oklahoma",19677,20012,19456,16779,15562,4115
2139,40093,"Major County, Oklahoma",7654,7487,7545,8055,8772,-1118
2140,40095,"Marshall County, Oklahoma",16688,15465,13184,10829,10550,6138
2141,40097,"Mayes County, Oklahoma",41098,40807,38369,33366,32261,8837
2142,40099,"Murray County, Oklahoma",13972,13193,12623,12042,12147,1825
2143,40101,"Muskogee County, Oklahoma",68451,70383,69451,68078,66939,1512
2144,40103,"Noble County, Oklahoma",11263,11509,11411,11045,11573,-310
2145,40105,"Nowata County, Oklahoma",10243,10674,10569,9992,11486,-1243
2146,40107,"Okfuskee County, Oklahoma",11987,12036,11814,11551,11125,862
2147,40109,"Oklahoma County, Oklahoma",792668,704023,660448,599611,568933,223735
2148,40111,"Okmulgee County, Oklahoma",38553,39664,39685,36490,39169,-616
2149,40113,"Osage County, Oklahoma",47074,47192,44437,41645,39327,7747
2150,40115,"Ottawa County, Oklahoma",31283,32193,33194,30561,32870,-1587
2151,40117,"Pawnee County, Oklahoma",16402,16564,16612,15575,15310,1092
2152,40119,"Payne County, Oklahoma",81912,75687,68190,61507,62435,19477
2153,40121,"Pittsburg County, Oklahoma",43955,45417,43953,40581,40524,3431
2154,40123,"Pontotoc County, Oklahoma",38385,36644,35143,34119,32598,5787
2155,40125,"Pottawatomie County, Oklahoma",72511,68751,65521,58760,55239,17272
2156,40127,"Pushmataha County, Oklahoma",11055,11500,11667,10997,11773,-718
2157,40129,"Roger Mills County, Oklahoma",3635,3530,3436,4147,4799,-1164
2158,40131,"Rogers County, Oklahoma",92052,85044,70641,55170,46436,45616
2159,40133,"Seminole County, Oklahoma",24624,25224,24894,25412,27473,-2849
2160,40135,"Sequoyah County, Oklahoma",41687,41855,38972,33828,30749,10938
2161,40137,"Stephens County, Oklahoma",43401,44454,43182,42299,43419,-18
2162,40139,"Texas County, Oklahoma",20633,19826,20107,16419,17727,2906
2163,40141,"Tillman County, Oklahoma",7347,8154,9287,10384,12398,-5051
2164,40143,"Tulsa County, Oklahoma",650291,589757,563299,503341,470593,179698
2165,40145,"Wagoner County, Oklahoma",80264,70232,57491,47883,41801,38463
2166,40147,"Washington County, Oklahoma",51995,50339,48996,48066,48113,3882
2167,40149,"Washita County, Oklahoma",11066,11571,11508,11441,13798,-2732
2168,40151,"Woods County, Oklahoma",8914,8656,9089,9103,10923,-2009
2169,40153,"Woodward County, Oklahoma",20352,19967,18486,18976,21172,-820
2170,41001,"Baker County, Oregon",16090,16150,16741,15317,16134,-44
2171,41003,"Benton County, Oregon",92168,84158,78153,70811,68211,23957
2172,41005,"Clackamas County, Oregon",415084,370479,338391,278850,241919,173165
2173,41007,"Clatsop County, Oregon",39656,36858,35630,33301,32489,7167
2174,41009,"Columbia County, Oregon",52117,49006,43560,37557,35646,16471
2175,41011,"Coos County, Oregon",64175,63319,62779,60273,64047,128
2176,41013,"Crook County, Oregon",23733,21515,19182,14111,13091,10642
2177,41015,"Curry County, Oregon",22889,22411,21137,19327,16992,5897
2178,41017,"Deschutes County, Oregon",191749,154568,115367,74958,62142,129607
2179,41019,"Douglas County, Oregon",110015,107209,100399,94649,93748,16267
2180,41021,"Gilliam County, Oregon",1896,1731,1915,1717,2057,-161
2181,41023,"Grant County, Oregon",7174,7349,7935,7853,8210,-1036
2182,41025,"Harney County, Oregon",7310,7364,7609,7060,8314,-1004
2183,41027,"Hood River County, Oregon",23270,21706,20411,16903,15835,7435
2184,41029,"Jackson County, Oregon",218781,200587,181269,146389,132456,86325
2185,41031,"Jefferson County, Oregon",24048,21652,19009,13676,11599,12449
2186,41033,"Josephine County, Oregon",87097,82172,75726,62649,58855,28242
2187,41035,"Klamath County, Oregon",67606,66520,63775,57702,59117,8489
2188,41037,"Lake County, Oregon",7896,7882,7422,7186,7532,364
2189,41039,"Lane County, Oregon",377749,347156,322959,282912,275226,102523
2190,41041,"Lincoln County, Oregon",49336,45857,44479,38889,35264,14072
2191,41043,"Linn County, Oregon",127216,114315,103069,91227,89495,37721
2192,41045,"Malheur County, Oregon",30632,31326,31615,26038,26896,3736
2193,41047,"Marion County, Oregon",343742,309894,284834,228483,204692,139050
2194,41049,"Morrow County, Oregon",11425,11112,10995,7625,7519,3906
2195,41051,"Multnomah County, Oregon",809869,712036,660486,583887,562640,247229
2196,41053,"Polk County, Oregon",84730,73745,62380,49541,45203,39527
2197,41055,"Sherman County, Oregon",1686,1819,1934,1918,2172,-486
2198,41057,"Tillamook County, Oregon",26782,25200,24262,21570,21164,5618
2199,41059,"Umatilla County, Oregon",77319,74804,70548,59249,58861,18458
2200,41061,"Union County, Oregon",26502,25373,24530,23598,23921,2581
2201,41063,"Wallowa County, Oregon",7065,6919,7226,6911,7273,-208
2202,41065,"Wasco County, Oregon",26274,24695,23791,21683,21732,4542
2203,41067,"Washington County, Oregon",595761,516665,445342,311554,245808,349953
2204,41069,"Wheeler County, Oregon",1417,1443,1547,1396,1513,-96
2205,41071,"Yamhill County, Oregon",106087,96930,84992,65551,55332,50755
2206,42001,"Adams County, Pennsylvania",102627,100839,91292,78274,68292,34335
2207,42003,"Allegheny County, Pennsylvania",1218380,1223066,1281666,1336449,1450085,-231705
2208,42005,"Armstrong County, Pennsylvania",65356,69489,72392,73478,77768,-12412
2209,42007,"Beaver County, Pennsylvania",164781,171569,181412,186093,204441,-39660
2210,42009,"Bedford County, Pennsylvania",48154,49882,49984,47919,46784,1370
2211,42011,"Berks County, Pennsylvania",419062,407310,373638,336523,312509,106553
2212,42013,"Blair County, Pennsylvania",122495,127071,129144,130542,136621,-14126
2213,42015,"Bradford County, Pennsylvania",60721,62415,62761,60967,62919,-2198
2214,42017,"Bucks County, Pennsylvania",627668,622859,597635,541174,479211,148457
2215,42019,"Butler County, Pennsylvania",187798,182554,174083,152013,147912,39886
2216,42021,"Cambria County, Pennsylvania",131611,144741,152598,163029,183263,-51652
2217,42023,"Cameron County, Pennsylvania",4512,5197,5974,5913,6674,-2162
2218,42025,"Carbon County, Pennsylvania",63964,64563,58802,56846,53285,10679
2219,42027,"Centre County, Pennsylvania",162264,151411,135758,123786,112760,49504
2220,42029,"Chester County, Pennsylvania",521980,490571,433501,376396,316660,205320
2221,42031,"Clarion County, Pennsylvania",38633,40290,41765,41699,43362,-4729
2222,42033,"Clearfield County, Pennsylvania",79466,82131,83382,78097,83578,-4112
2223,42035,"Clinton County, Pennsylvania",38549,38970,37914,37182,38971,-422
2224,42037,"Columbia County, Pennsylvania",65390,66642,64151,63202,61967,3423
2225,42039,"Crawford County, Pennsylvania",85074,89153,90366,86169,88869,-3795
2226,42041,"Cumberland County, Pennsylvania",251487,231336,213674,195257,178541,72946
2227,42043,"Dauphin County, Pennsylvania",277071,264823,251798,237813,232317,44754
2228,42045,"Delaware County, Pennsylvania",565328,556468,550864,547651,555007,10321
2229,42047,"Elk County, Pennsylvania",30077,32480,35112,34878,38338,-8261
2230,42049,"Erie County, Pennsylvania",272046,279234,280843,275572,279780,-7734
2231,42051,"Fayette County, Pennsylvania",130329,138807,148644,145351,159417,-29088
2232,42053,"Forest County, Pennsylvania",7190,7585,4946,4802,5072,2118
2233,42055,"Franklin County, Pennsylvania",154954,146558,129313,121082,113629,41325
2234,42057,"Fulton County, Pennsylvania",14492,14839,14261,13837,12842,1650
2235,42059,"Greene County, Pennsylvania",36484,39003,40672,39550,40476,-3992
2236,42061,"Huntingdon County, Pennsylvania",45145,45830,45586,44164,42253,2892
2237,42063,"Indiana County, Pennsylvania",84463,88745,89605,89994,92281,-7818
2238,42065,"Jefferson County, Pennsylvania",43570,45244,45932,46083,48303,-4733
2239,42067,"Juniata County, Pennsylvania",24657,24385,22821,20625,19188,5469
2240,42069,"Lackawanna County, Pennsylvania",210162,213731,213295,219039,227908,-17746
2241,42071,"Lancaster County, Pennsylvania",543050,511250,470658,422822,362346,180704
2242,42073,"Lawrence County, Pennsylvania",86148,91682,94643,96246,107150,-21002
2243,42075,"Lebanon County, Pennsylvania",140410,131341,120327,113744,108582,31828
2244,42077,"Lehigh County, Pennsylvania",367338,343946,312090,291130,272349,94989
2245,42079,"Luzerne County, Pennsylvania",317547,319120,319250,328149,343079,-25532
2246,42081,"Lycoming County, Pennsylvania",114014,116376,120044,118710,118416,-4402
2247,42083,"Mckean County, Pennsylvania",41021,43853,45936,47131,50635,-9614
2248,42085,"Mercer County, Pennsylvania",110519,117296,120293,121003,128299,-17780
2249,42087,"Mifflin County, Pennsylvania",46179,46583,46486,46197,46908,-729
2250,42089,"Monroe County, Pennsylvania",168824,168080,138687,95709,69409,99415
2251,42091,"Montgomery County, Pennsylvania",827180,790497,750097,678111,643621,183559
2252,42093,"Montour County, Pennsylvania",18178,18152,18236,17735,16675,1503
2253,42095,"Northampton County, Pennsylvania",304233,294536,267066,247105,225418,78815
2254,42097,"Northumberland County, Pennsylvania",91234,94099,94556,96771,100381,-9147
2255,42099,"Perry County, Pennsylvania",46133,45599,43602,41172,35718,10415
2256,42101,"Philadelphia County, Pennsylvania",1581531,1504950,1517550,1585577,1688210,-106679
2257,42103,"Pike County, Pennsylvania",55660,56993,46302,27966,18271,37389
2258,42105,"Potter County, Pennsylvania",16685,17583,18080,16717,17726,-1041
2259,42107,"Schuylkill County, Pennsylvania",141935,148288,150336,152585,160630,-18695
2260,42109,"Snyder County, Pennsylvania",40452,39400,37546,36680,33584,6868
2261,42111,"Somerset County, Pennsylvania",73844,78219,80023,78218,81243,-7399
2262,42113,"Sullivan County, Pennsylvania",6038,6467,6556,6104,6349,-311
2263,42115,"Susquehanna County, Pennsylvania",40604,43343,42238,40380,37876,2728
2264,42117,"Tioga County, Pennsylvania",40759,41631,41373,41126,40973,-214
2265,42119,"Union County, Pennsylvania",44831,44866,41624,36176,32870,11961
2266,42121,"Venango County, Pennsylvania",51355,55320,57565,59381,64444,-13089
2267,42123,"Warren County, Pennsylvania",39466,41877,43863,45050,47449,-7983
2268,42125,"Washington County, Pennsylvania",207081,206987,202897,204584,217074,-9993
2269,42127,"Wayne County, Pennsylvania",51268,52302,47722,39944,35237,16031
2270,42129,"Westmoreland County, Pennsylvania",350722,365841,369993,370321,392294,-41572
2271,42131,"Wyoming County, Pennsylvania",27078,28262,28080,28076,26433,645
2272,42133,"York County, Pennsylvania",447628,428175,381751,339574,312963,134665
2273,44001,"Bristol County, Rhode Island",48645,50501,50648,48859,46942,1703
2274,44003,"Kent County, Rhode Island",164122,167235,167090,161135,154163,9959
2275,44005,"Newport County, Rhode Island",82731,83253,85433,87194,81383,1348
2276,44007,"Providence County, Rhode Island",636161,628413,621602,596270,571349,64812
2277,44009,"Washington County, Rhode Island",126139,126987,123546,110006,93317,32822
2278,45001,"Abbeville County, South Carolina",24582,25643,26167,23862,22627,1955
2279,45003,"Aiken County, South Carolina",169947,156670,142552,120940,105625,64322
2280,45005,"Allendale County, South Carolina",8789,10688,11211,11722,10700,-1911
2281,45007,"Anderson County, South Carolina",200183,183691,165740,145196,133235,66948
2282,45009,"Bamberg County, South Carolina",14236,16139,16658,16902,18118,-3882
2283,45011,"Barnwell County, South Carolina",21170,22748,23478,20293,19868,1302
2284,45013,"Beaufort County, South Carolina",189732,155550,120937,86425,65364,124368
2285,45015,"Berkeley County, South Carolina",222103,169878,142651,128776,94727,127376
2286,45017,"Calhoun County, South Carolina",14608,15212,15185,12753,12206,2402
2287,45019,"Charleston County, South Carolina",407543,342434,309969,295039,276974,130569
2288,45021,"Cherokee County, South Carolina",57110,54832,52537,44506,40983,16127
2289,45023,"Chester County, South Carolina",32260,33246,34068,32170,30148,2112
2290,45025,"Chesterfield County, South Carolina",45833,46087,42768,38577,38161,7672
2291,45027,"Clarendon County, South Carolina",33865,34621,32502,28450,27464,6401
2292,45029,"Colleton County, South Carolina",37624,38833,38264,34377,31776,5848
2293,45031,"Darlington County, South Carolina",66858,68602,67394,61851,62717,4141
2294,45033,"Dillon County, South Carolina",30473,31666,30722,29114,31083,-610
2295,45035,"Dorchester County, South Carolina",161309,129618,96413,83060,58761,102548
2296,45037,"Edgefield County, South Carolina",27021,26680,24595,18375,17528,9493
2297,45039,"Fairfield County, South Carolina",22406,24040,23454,22295,20700,1706
2298,45041,"Florence County, South Carolina",138237,134897,125761,114344,110163,28074
2299,45043,"Georgetown County, South Carolina",62150,60236,55797,46302,42461,19689
2300,45045,"Greenville County, South Carolina",516126,436437,379616,320167,287913,228213
2301,45047,"Greenwood County, South Carolina",70672,68890,66271,59567,57847,12825
2302,45049,"Hampton County, South Carolina",19223,21173,21386,18191,18159,1064
2303,45051,"Horry County, South Carolina",344186,258267,196629,144053,101419,242767
2304,45053,"Jasper County, South Carolina",29558,23634,20678,15487,14504,15054
2305,45055,"Kershaw County, South Carolina",65926,60166,52647,43599,39015,26911
2306,45057,"Lancaster County, South Carolina",95378,72302,61351,54516,53361,42017
2307,45059,"Laurens County, South Carolina",66990,67026,69567,58092,52214,14776
2308,45061,"Lee County, South Carolina",17144,19615,20119,18437,18929,-1785
2309,45063,"Lexington County, South Carolina",295033,252563,216014,167611,140353,154680
2310,45065,"Mccormick County, South Carolina",9495,10203,9958,8868,7797,1698
2311,45067,"Marion County, South Carolina",30954,33568,35466,33899,34179,-3225
2312,45069,"Marlboro County, South Carolina",26376,29112,28818,29361,31634,-5258
2313,45071,"Newberry County, South Carolina",38329,37197,36108,33172,31242,7087
2314,45073,"Oconee County, South Carolina",78314,73035,66215,57494,48611,29703
2315,45075,"Orangeburg County, South Carolina",86953,92475,91582,84803,82276,4677
2316,45077,"Pickens County, South Carolina",125381,117823,110757,93894,79292,46089
2317,45079,"Richland County, South Carolina",414660,372597,320677,285720,269735,144925
2318,45081,"Saluda County, South Carolina",20292,19567,19181,16357,16150,4142
2319,45083,"Spartanburg County, South Carolina",313791,278167,253791,226800,201861,111930
2320,45085,"Sumter County, South Carolina",106675,106601,104646,102637,88243,18432
2321,45087,"Union County, South Carolina",27325,29089,29881,30337,30751,-3426
2322,45089,"Williamsburg County, South Carolina",30810,34994,37217,36815,38226,-7416
2323,45091,"York County, South Carolina",273887,214916,164614,131497,106720,167167
2324,46003,"Aurora County, South Dakota",2757,2739,3058,3135,3628,-871
2325,46005,"Beadle County, South Dakota",18338,16829,17023,18253,19195,-857
2326,46007,"Bennett County, South Dakota",3430,3441,3574,3206,3044,386
2327,46009,"Bon Homme County, South Dakota",6914,7080,7260,7089,8059,-1145
2328,46011,"Brookings County, South Dakota",35115,31250,28220,25207,24332,10783
2329,46013,"Brown County, South Dakota",38988,36011,35460,35580,36962,2026
2330,46015,"Brule County, South Dakota",5233,5128,5364,5485,5245,-12
2331,46017,"Buffalo County, South Dakota",2005,1932,2032,1759,1795,210
2332,46019,"Butte County, South Dakota",10295,9888,9094,7914,8372,1923
2333,46021,"Campbell County, South Dakota",1458,1431,1782,1965,2243,-785
2334,46023,"Charles Mix County, South Dakota",9324,9075,9350,9131,9680,-356
2335,46025,"Clark County, South Dakota",3715,3702,4143,4403,4894,-1179
2336,46027,"Clay County, South Dakota",14076,13816,13537,13186,13689,387
2337,46029,"Codington County, South Dakota",28133,27040,25897,22698,20885,7248
2338,46031,"Corson County, South Dakota",4106,4053,4181,4195,5196,-1090
2339,46033,"Custer County, South Dakota",8826,8085,7275,6179,6000,2826
2340,46035,"Davison County, South Dakota",19890,19397,18741,17503,17820,2070
2341,46037,"Day County, South Dakota",5452,5714,6267,6978,8133,-2681
2342,46039,"Deuel County, South Dakota",4309,4373,4498,4522,5289,-980
2343,46041,"Dewey County, South Dakota",5841,5354,5972,5523,5366,475
2344,46043,"Douglas County, South Dakota",2913,3046,3458,3746,4181,-1268
2345,46045,"Edmunds County, South Dakota",3876,4047,4367,4356,5159,-1283
2346,46047,"Fall River County, South Dakota",6721,7078,7453,7353,8439,-1718
2347,46049,"Faulk County, South Dakota",2315,2386,2640,2744,3327,-1012
2348,46051,"Grant County, South Dakota",7125,7382,7847,8372,9013,-1888
2349,46053,"Gregory County, South Dakota",4193,4272,4792,5359,6015,-1822
2350,46055,"Haakon County, South Dakota",1935,1886,2196,2624,2794,-859
2351,46057,"Hamlin County, South Dakota",6104,5761,5540,4974,5261,843
2352,46059,"Hand County, South Dakota",3064,3402,3741,4272,4948,-1884
2353,46061,"Hanson County, South Dakota",3423,3382,3139,2994,3415,8
2354,46063,"Harding County, South Dakota",1178,1250,1353,1669,1700,-522
2355,46065,"Hughes County, South Dakota",17560,16827,16481,14817,14220,3340
2356,46067,"Hutchinson County, South Dakota",7308,7388,8075,8262,9350,-2042
2357,46069,"Hyde County, South Dakota",1446,1520,1671,1696,2069,-623
2358,46071,"Jackson County, South Dakota",3296,2991,2930,2811,3437,-141
2359,46073,"Jerauld County, South Dakota",2009,2038,2295,2425,2929,-920
2360,46075,"Jones County, South Dakota",873,1076,1193,1324,1463,-590
2361,46077,"Kingsbury County, South Dakota",4936,5169,5815,5925,6679,-1743
2362,46079,"Lake County, South Dakota",12747,11008,11276,10550,10724,2023
2363,46081,"Lawrence County, South Dakota",25806,23670,21802,20655,18339,7467
2364,46083,"Lincoln County, South Dakota",58887,41289,24131,15427,13942,44945
2365,46085,"Lyman County, South Dakota",3831,3736,3895,3638,3864,-33
2366,46087,"Mccook County, South Dakota",5543,5639,5832,5688,6444,-901
2367,46089,"Mcpherson County, South Dakota",2316,2506,2904,3228,4027,-1711
2368,46091,"Marshall County, South Dakota",4881,4618,4576,4844,5404,-523
2369,46093,"Meade County, South Dakota",28149,25156,24253,21878,20717,7432
2370,46095,"Mellette County, South Dakota",2065,2032,2083,2137,2249,-184
2371,46097,"Miner County, South Dakota",2213,2411,2884,3272,3739,-1526
2372,46099,"Minnehaha County, South Dakota",191682,165799,148281,123809,109435,82247
2373,46101,"Moody County, South Dakota",6508,6511,6595,6507,6692,-184
2374,46103,"Pennington County, South Dakota",112504,97922,88565,81343,70361,42143
2375,46105,"Perkins County, South Dakota",2996,2976,3363,3932,4700,-1704
2376,46107,"Potter County, South Dakota",2311,2380,2693,3190,3674,-1363
2377,46109,"Roberts County, South Dakota",10310,10033,10016,9914,10911,-601
2378,46111,"Sanborn County, South Dakota",2372,2380,2675,2833,3213,-841
2379,46115,"Spink County, South Dakota",6438,6518,7454,7981,9201,-2763
2380,46117,"Stanley County, South Dakota",3058,2896,2772,2453,2533,525
2381,46119,"Sully County, South Dakota",1278,1328,1556,1589,1990,-712
2382,46121,"Todd County, South Dakota",10308,9575,9050,8352,7328,2980
2383,46123,"Tripp County, South Dakota",5448,5743,6430,6924,7268,-1820
2384,46125,"Turner County, South Dakota",8325,8368,8849,8576,9255,-930
2385,46127,"Union County, South Dakota",15659,13903,12584,10189,10938,4721
2386,46129,"Walworth County, South Dakota",5431,5408,5974,6087,7011,-1580
2387,46135,"Yankton County, South Dakota",22746,22216,21652,19252,18952,3794
2388,46137,"Ziebach County, South Dakota",2767,2765,2519,2220,2308,459
2389,47001,"Anderson County, Tennessee",76513,74257,71330,68250,67346,9167
2390,47003,"Bedford County, Tennessee",48937,44172,37586,30411,27916,21021
2391,47005,"Benton County, Tennessee",16133,16456,16537,14524,14901,1232
2392,47007,"Bledsoe County, Tennessee",14961,12946,12367,9669,9478,5483
2393,47009,"Blount County, Tennessee",131641,121140,105823,85969,77770,53871
2394,47011,"Bradley County, Tennessee",106924,97192,87965,73712,67547,39377
2395,47013,"Campbell County, Tennessee",39818,40623,39854,35079,34923,4895
2396,47015,"Cannon County, Tennessee",14374,13631,12826,10467,10234,4140
2397,47017,"Carroll County, Tennessee",27841,28644,29475,27514,28285,-444
2398,47019,"Carter County, Tennessee",56452,57710,56742,51505,50205,6247
2399,47021,"Cheatham County, Tennessee",40539,38809,35912,27140,21616,18923
2400,47023,"Chester County, Tennessee",17260,16793,15540,12819,12727,4533
2401,47025,"Claiborne County, Tennessee",31827,31901,29862,26137,24595,7232
2402,47027,"Clay County, Tennessee",7640,7888,7976,7238,7676,-36
2403,47029,"Cocke County, Tennessee",35797,35473,33565,29141,28792,7005
2404,47031,"Coffee County, Tennessee",56024,52344,48014,40339,38311,17713
2405,47033,"Crockett County, Tennessee",14310,14524,14532,13378,14941,-631
2406,47035,"Cumberland County, Tennessee",60016,54977,46802,34736,28676,31340
2407,47037,"Davidson County, Tennessee",690540,612884,569891,510784,477811,212729
2408,47039,"Decatur County, Tennessee",11663,11716,11731,10472,10857,806
2409,47041,"De Kalb County, Tennessee",20104,18569,17423,14360,13589,6515
2410,47043,"Dickson County, Tennessee",53289,48712,43156,35061,30037,23252
2411,47045,"Dyer County, Tennessee",37201,38174,37279,34854,34663,2538
2412,47047,"Fayette County, Tennessee",40612,37458,28806,25559,25305,15307
2413,47049,"Fentress County, Tennessee",18405,17777,16625,14669,14826,3579
2414,47051,"Franklin County, Tennessee",41999,41054,39270,34725,31983,10016
2415,47053,"Gibson County, Tennessee",49193,49015,48152,46315,49467,-274
2416,47055,"Giles County, Tennessee",29403,29558,29447,25741,24625,4778
2417,47057,"Grainger County, Tennessee",23268,22419,20659,17095,16751,6517
2418,47059,"Greene County, Tennessee",69077,68172,62909,55853,54422,14655
2419,47061,"Grundy County, Tennessee",13371,13910,14332,13362,13787,-416
2420,47063,"Hamblen County, Tennessee",64479,61857,58128,50480,49300,15179
2421,47065,"Hamilton County, Tennessee",364718,328960,307896,285536,287740,76978
2422,47067,"Hancock County, Tennessee",6568,6782,6786,6739,6887,-319
2423,47069,"Hardeman County, Tennessee",25247,27655,28105,23377,23873,1374
2424,47071,"Hardin County, Tennessee",25665,25995,25578,22633,22280,3385
2425,47073,"Hawkins County, Tennessee",56735,56562,53563,44565,43751,12984
2426,47075,"Haywood County, Tennessee",17391,19010,19797,19437,20318,-2927
2427,47077,"Henderson County, Tennessee",27956,27518,25522,21844,21390,6566
2428,47079,"Henry County, Tennessee",32251,32042,31115,27888,28656,3595
2429,47081,"Hickman County, Tennessee",25017,24506,22295,16754,15151,9866
2430,47083,"Houston County, Tennessee",8201,8286,8088,7018,6871,1330
2431,47085,"Humphreys County, Tennessee",18528,18416,17929,15795,15957,2571
2432,47087,"Jackson County, Tennessee",11767,11491,10984,9297,9398,2369
2433,47089,"Jefferson County, Tennessee",54162,50600,44294,33016,31284,22878
2434,47091,"Johnson County, Tennessee",17755,18190,17499,13766,13745,4010
2435,47093,"Knox County, Tennessee",466184,423748,382032,335749,319694,146490
2436,47095,"Lake County, Tennessee",7273,7827,7954,7129,7455,-182
2437,47097,"Lauderdale County, Tennessee",25689,27745,27101,23491,24555,1134
2438,47099,"Lawrence County, Tennessee",43780,41319,39926,35303,34110,9670
2439,47101,"Lewis County, Tennessee",12131,12003,11367,9247,9700,2431
2440,47103,"Lincoln County, Tennessee",34158,32885,31340,28157,26483,7675
2441,47105,"Loudon County, Tennessee",53169,47102,39086,31255,28553,24616
2442,47107,"Mcminn County, Tennessee",53392,52075,49015,42383,41878,11514
2443,47109,"Mcnairy County, Tennessee",25814,25760,24653,22422,22525,3289
2444,47111,"Macon County, Tennessee",24208,21934,20386,15906,15700,8508
2445,47113,"Madison County, Tennessee",97838,97378,91837,77982,74546,23292
2446,47115,"Marion County, Tennessee",28639,28123,27776,24860,24416,4223
2447,47117,"Marshall County, Tennessee",33708,29902,26767,21539,19698,14010
2448,47119,"Maury County, Tennessee",94615,79029,69498,54812,51095,43520
2449,47121,"Meigs County, Tennessee",12237,11581,11086,8033,7431,4806
2450,47123,"Monroe County, Tennessee",46413,44015,38961,30541,28700,17713
2451,47125,"Montgomery County, Tennessee",204992,163603,134768,100498,83342,121650
2452,47127,"Moore County, Tennessee",6396,6266,5740,4721,4510,1886
2453,47129,"Morgan County, Tennessee",21538,21664,19757,17300,16604,4934
2454,47131,"Obion County, Tennessee",30343,31905,32450,31717,32781,-2438
2455,47133,"Overton County, Tennessee",22171,21777,20118,17636,17575,4596
2456,47135,"Perry County, Tennessee",8020,7778,7631,6612,6111,1909
2457,47137,"Pickett County, Tennessee",5068,5072,4945,4548,4358,710
2458,47139,"Polk County, Tennessee",16807,16690,16050,13643,13602,3205
2459,47141,"Putnam County, Tennessee",78542,70570,62315,51373,47690,30852
2460,47143,"Rhea County, Tennessee",32964,31215,28400,24344,24235,8729
2461,47145,"Roane County, Tennessee",53331,54156,51910,47227,48425,4906
2462,47147,"Robertson County, Tennessee",70982,64347,54433,41494,37021,33961
2463,47149,"Rutherford County, Tennessee",324139,250517,182023,118570,84058,240081
2464,47151,"Scott County, Tennessee",22020,22171,21127,18358,19259,2761
2465,47153,"Sequatchie County, Tennessee",14936,13814,11370,8863,8605,6331
2466,47155,"Sevier County, Tennessee",98007,87507,71170,51043,41418,56589
2467,47157,"Shelby County, Tennessee",936611,922696,897472,826330,777113,159498
2468,47159,"Smith County, Tennessee",19926,19035,17712,14143,14935,4991
2469,47161,"Stewart County, Tennessee",13553,13133,12370,9479,8665,4888
2470,47163,"Sullivan County, Tennessee",157707,155815,153048,143596,143968,13739
2471,47165,"Sumner County, Tennessee",187680,155592,130449,103281,85790,101890
2472,47167,"Tipton County, Tennessee",61562,59689,51271,37568,32930,28632
2473,47169,"Trousdale County, Tennessee",10910,7751,7259,5920,6137,4773
2474,47171,"Unicoi County, Tennessee",17821,18257,17667,16549,16362,1459
2475,47173,"Union County, Tennessee",19678,19088,17808,13694,11707,7971
2476,47175,"Van Buren County, Tennessee",5813,5503,5508,4846,4728,1085
2477,47177,"Warren County, Tennessee",40971,39539,38276,32992,32653,8318
2478,47179,"Washington County, Tennessee",128874,119768,107198,92315,88755,40119
2479,47181,"Wayne County, Tennessee",16638,17016,16842,13935,13946,2692
2480,47183,"Weakley County, Tennessee",33377,34557,34895,31972,32896,481
2481,47185,"White County, Tennessee",27087,25460,23102,20090,19567,7520
2482,47187,"Williamson County, Tennessee",232380,174260,126638,81021,58108,174272
2483,47189,"Wilson County, Tennessee",140604,109563,88809,67675,56064,84540
2484,48001,"Anderson County, Texas",57917,58016,55109,48024,38381,19536
2485,48003,"Andrews County, Texas",18227,14048,13004,14338,13323,4904
2486,48005,"Angelina County, Texas",87119,85254,80130,69884,64172,22947
2487,48007,"Aransas County, Texas",24220,23247,22497,17892,14260,9960
2488,48009,"Archer County, Texas",8754,9055,8854,7973,7266,1488
2489,48011,"Armstrong County, Texas",1950,1958,2148,2021,1994,-44
2490,48013,"Atascosa County, Texas",50194,44049,38628,30533,25055,25139
2491,48015,"Austin County, Texas",29892,27783,23590,19832,17726,12166
2492,48017,"Bailey County, Texas",6916,7027,6594,7064,8168,-1252
2493,48019,"Bandera County, Texas",22770,20265,17645,10562,7084,15686
2494,48021,"Bastrop County, Texas",86839,72289,57733,38263,24726,62113
2495,48023,"Baylor County, Texas",3560,3795,4093,4385,4919,-1359
2496,48025,"Bee County, Texas",32609,31896,32359,25135,26030,6579
2497,48027,"Bell County, Texas",355700,294689,237974,191088,157889,197811
2498,48029,"Bexar County, Texas",1978826,1650052,1392931,1185394,988800,990026
2499,48031,"Blanco County, Texas",11733,10085,8418,5972,4681,7052
2500,48033,"Borden County, Texas",653,564,729,799,859,-206
2501,48035,"Bosque County, Texas",18428,18067,17204,15125,13401,5027
2502,48037,"Bowie County, Texas",93622,91399,89306,81665,75301,18321
2503,48039,"Brazoria County, Texas",368062,300522,241767,191707,169587,198475
2504,48041,"Brazos County, Texas",226370,185426,152415,121862,93588,132782
2505,48043,"Brewster County, Texas",9231,8971,8866,8681,7573,1658
2506,48045,"Briscoe County, Texas",1348,1723,1790,1971,2579,-1231
2507,48047,"Brooks County, Texas",7100,7349,7976,8204,8428,-1328
2508,48049,"Brown County, Texas",37805,38199,37674,34371,33057,4748
2509,48051,"Burleson County, Texas",18237,17058,16470,13625,12313,5924
2510,48053,"Burnet County, Texas",47548,42215,34147,22677,17803,29745
2511,48055,"Caldwell County, Texas",42817,37416,32194,26392,23637,19180
2512,48057,"Calhoun County, Texas",21470,21120,20647,19053,19574,1896
2513,48059,"Callahan County, Texas",13959,13458,12905,11859,10992,2967
2514,48061,"Cameron County, Texas",422135,393566,335227,260120,209727,212408
2515,48063,"Camp County, Texas",12938,12288,11549,9904,9275,3663
2516,48065,"Carson County, Texas",5957,6284,6516,6576,6672,-715
2517,48067,"Cass County, Texas",30002,30254,30438,29982,29430,572
2518,48069,"Castro County, Texas",7561,7848,8285,9070,10556,-2995
2519,48071,"Chambers County, Texas",42571,32371,26031,20088,18538,24033
2520,48073,"Cherokee County, Texas",52341,50035,46659,41049,38127,14214
2521,48075,"Childress County, Texas",7219,7115,7688,5953,6950,269
2522,48077,"Clay County, Texas",10444,10922,11006,10024,9582,862
2523,48079,"Cochran County, Texas",2860,3155,3730,4377,4825,-1965
2524,48081,"Coke County, Texas",3298,3301,3864,3424,3196,102
2525,48083,"Coleman County, Texas",8281,8857,9235,9710,10439,-2158
2526,48085,"Collin County, Texas",1006038,738745,491675,264036,144576,861462
2527,48087,"Collingsworth County, Texas",2939,3009,3206,3573,4648,-1709
2528,48089,"Colorado County, Texas",21357,20751,20390,18383,18823,2534
2529,48091,"Comal County, Texas",148921,102836,78021,51832,36446,112475
2530,48093,"Comanche County, Texas",13597,13863,14026,13381,12617,980
2531,48095,"Concho County, Texas",3018,4047,3966,3044,2915,103
2532,48097,"Cooke County, Texas",40428,38316,36363,30777,27656,12772
2533,48099,"Coryell County, Texas",75576,74082,74978,64213,56767,18809
2534,48101,"Cottle County, Texas",1624,1618,1904,2247,2947,-1323
2535,48103,"Crane County, Texas",4739,4141,3996,4652,4600,139
2536,48105,"Crockett County, Texas",3393,3746,4099,4078,4608,-1215
2537,48107,"Crosby County, Texas",5753,6207,7072,7304,8859,-3106
2538,48109,"Culberson County, Texas",2183,2480,2975,3407,3315,-1132
2539,48111,"Dallam County, Texas",7272,6471,6222,5461,6531,741
2540,48113,"Dallas County, Texas",2622634,2321014,2218899,1852810,1556390,1066244
2541,48115,"Dawson County, Texas",12849,13853,14985,14349,16184,-3335
2542,48117,"Deaf Smith County, Texas",18617,19054,18561,19153,21165,-2548
2543,48119,"Delta County, Texas",5277,5248,5327,4857,4839,438
2544,48121,"Denton County, Texas",861690,628084,432976,273525,143126,718564
2545,48123,"De Witt County, Texas",20217,20025,20013,18840,18903,1314
2546,48125,"Dickens County, Texas",2182,2441,2762,2571,3539,-1357
2547,48127,"Dimmit County, Texas",10232,9908,10248,10433,11367,-1135
2548,48129,"Donley County, Texas",3317,3655,3828,3696,4075,-758
2549,48131,"Duval County, Texas",11194,11999,13120,12918,12517,-1323
2550,48133,"Eastland County, Texas",18289,18560,18297,18488,19480,-1191
2551,48135,"Ector County, Texas",162067,133015,121123,118934,115374,46693
2552,48137,"Edwards County, Texas",1944,2029,2162,2266,2033,-89
2553,48139,"Ellis County, Texas",179484,143502,111360,85167,59743,119741
2554,48141,"El Paso County, Texas",836915,772280,679622,591610,479899,357016
2555,48143,"Erath County, Texas",42226,37142,33001,27991,22560,19666
2556,48145,"Falls County, Texas",17281,17799,18576,17712,17946,-665
2557,48147,"Fannin County, Texas",35046,33765,31242,24804,24285,10761
2558,48149,"Fayette County, Texas",25247,24175,21804,20095,18832,6415
2559,48151,"Fisher County, Texas",3827,4057,4344,4842,5891,-2064
2560,48153,"Floyd County, Texas",5782,6599,7771,8497,9834,-4052
2561,48155,"Foard County, Texas",1207,1379,1622,1794,2158,-951
2562,48157,"Fort Bend County, Texas",790892,541983,354452,225421,130846,660046
2563,48159,"Franklin County, Texas",10767,10675,9458,7802,6893,3874
2564,48161,"Freestone County, Texas",19744,19461,17867,15818,14830,4914
2565,48163,"Frio County, Texas",20013,16956,16252,13472,13785,6228
2566,48165,"Gaines County, Texas",21077,16658,14467,14123,13150,7927
2567,48167,"Galveston County, Texas",337600,286326,250158,217399,195940,141660
2568,48169,"Garza County, Texas",6028,6204,4872,5143,5336,692
2569,48171,"Gillespie County, Texas",26668,24197,20814,17204,13532,13136
2570,48173,"Glasscock County, Texas",1447,1317,1406,1447,1304,143
2571,48175,"Goliad County, Texas",7578,7161,6928,5980,5193,2385
2572,48177,"Gonzales County, Texas",20828,19635,18628,17205,16883,3945
2573,48179,"Gray County, Texas",22063,22497,22744,23967,26386,-4323
2574,48181,"Grayson County, Texas",133527,119111,110595,95021,89796,43731
2575,48183,"Gregg County, Texas",123633,119525,111379,104948,99487,24146
2576,48185,"Grimes County, Texas",28447,26208,23552,18828,13580,14867
2577,48187,"Guadalupe County, Texas",163030,122728,89023,64873,46708,116322
2578,48189,"Hale County, Texas",33463,36041,36602,34671,37592,-4129
2579,48191,"Hall County, Texas",3025,3424,3782,3905,5594,-2569
2580,48193,"Hamilton County, Texas",8434,8473,8229,7733,8297,137
2581,48195,"Hansford County, Texas",5431,5470,5369,5848,6209,-778
2582,48197,"Hardeman County, Texas",3958,4226,4724,5283,6368,-2410
2583,48199,"Hardin County, Texas",57356,53220,48073,41320,40721,16635
2584,48201,"Harris County, Texas",4680609,3950999,3400578,2818199,2409547,2271062
2585,48203,"Harrison County, Texas",66547,64484,62110,57483,52265,14282
2586,48205,"Hartley County, Texas",5588,5963,5537,3634,3987,1601
2587,48207,"Haskell County, Texas",5711,5842,6093,6820,7725,-2014
2588,48209,"Hays County, Texas",222827,146439,97589,65614,40594,182233
2589,48211,"Hemphill County, Texas",3901,3668,3351,3720,5304,-1403
2590,48213,"Henderson County, Texas",81969,78299,73277,58543,42606,39363
2591,48215,"Hidalgo County, Texas",861137,736973,569463,383545,283229,577908
2592,48217,"Hill County, Texas",36109,34854,32321,27146,25024,11085
2593,48219,"Hockley County, Texas",22986,22933,22716,24199,23230,-244
2594,48221,"Hood County, Texas",60025,49816,41100,28981,17714,42311
2595,48223,"Hopkins County, Texas",36708,34540,31960,28833,25247,11461
2596,48225,"Houston County, Texas",22942,23642,23185,21375,22299,643
2597,48227,"Howard County, Texas",36213,34285,33627,32343,33142,3071
2598,48229,"Hudspeth County, Texas",4687,3441,3344,2915,2728,1959
2599,48231,"Hunt County, Texas",96202,84836,76596,64343,55248,40954
2600,48233,"Hutchinson County, Texas",21105,22094,23857,25689,26304,-5199
2601,48235,"Irion County, Texas",1553,1673,1771,1629,1386,167
2602,48237,"Jack County, Texas",8888,9072,8763,6981,7408,1480
2603,48239,"Jackson County, Texas",14822,13987,14391,13039,13352,1470
2604,48241,"Jasper County, Texas",35562,35248,35604,31102,30781,4781
2605,48243,"Jeff Davis County, Texas",2245,2340,2207,1946,1647,598
2606,48245,"Jefferson County, Texas",253136,249349,252051,239397,250938,2198
2607,48247,"Jim Hogg County, Texas",5187,5211,5281,5109,5168,19
2608,48249,"Jim Wells County, Texas",40796,40631,39326,37679,36498,4298
2609,48251,"Johnson County, Texas",171359,147611,126811,97165,67649,103710
2610,48253,"Jones County, Texas",19874,20157,20785,16490,17268,2606
2611,48255,"Karnes County, Texas",15547,14880,15446,12455,13593,1954
2612,48257,"Kaufman County, Texas",129792,98402,71313,52220,39015,90777
2613,48259,"Kendall County, Texas",45491,31515,23743,14589,10635,34856
2614,48261,"Kenedy County, Texas",391,241,414,460,543,-152
2615,48263,"Kent County, Texas",704,772,859,1010,1145,-441
2616,48265,"Kerr County, Texas",52195,48826,43653,36304,28780,23415
2617,48267,"Kimble County, Texas",4375,4568,4468,4122,4063,312
2618,48269,"King County, Texas",279,219,356,354,425,-146
2619,48271,"Kinney County, Texas",3674,3555,3379,3119,2279,1395
2620,48273,"Kleberg County, Texas",30725,31611,31549,30274,33358,-2633
2621,48275,"Knox County, Texas",3679,3708,4253,4837,5329,-1650
2622,48277,"Lamar County, Texas",49705,49536,48499,43949,42156,7549
2623,48279,"Lamb County, Texas",13018,14092,14709,15072,18669,-5651
2624,48281,"Lampasas County, Texas",21152,19677,17762,13521,12005,9147
2625,48283,"La Salle County, Texas",7551,6709,5866,5254,5514,2037
2626,48285,"Lavaca County, Texas",20072,19217,19210,18690,19004,1068
2627,48287,"Lee County, Texas",17174,16499,15657,12854,10952,6222
2628,48289,"Leon County, Texas",17325,16640,15335,12665,9594,7731
2629,48291,"Liberty County, Texas",86173,74922,70154,52726,47088,39085
2630,48293,"Limestone County, Texas",23364,23170,22051,20946,20224,3140
2631,48295,"Lipscomb County, Texas",3301,3218,3057,3143,3766,-465
2632,48297,"Live Oak County, Texas",12175,11507,12309,9556,9606,2569
2633,48299,"Llano County, Texas",21452,18992,17044,11631,10144,11308
2634,48301,"Loving County, Texas",117,41,67,107,91,26
2635,48303,"Lubbock County, Texas",308392,269932,242628,222636,211651,96741
2636,48305,"Lynn County, Texas",5886,5988,6550,6758,8605,-2719
2637,48307,"Mcculloch County, Texas",7970,8220,8205,8778,8735,-765
2638,48309,"Mclennan County, Texas",254045,229587,213517,189123,170755,83290
2639,48311,"Mcmullen County, Texas",724,897,851,817,789,-65
2640,48313,"Madison County, Texas",14329,13433,12940,10931,10649,3680
2641,48315,"Marion County, Texas",9987,10771,10941,9984,10360,-373
2642,48317,"Martin County, Texas",5676,4606,4746,4956,4684,992
2643,48319,"Mason County, Texas",4248,3928,3738,3423,3683,565
2644,48321,"Matagorda County, Texas",36791,36647,37957,36928,37828,-1037
2645,48323,"Maverick County, Texas",58098,52493,47297,36378,31398,26700
2646,48325,"Medina County, Texas",50869,45073,39304,27312,23164,27705
2647,48327,"Menard County, Texas",2108,2212,2360,2252,2346,-238
2648,48329,"Midland County, Texas",171238,132103,116009,106611,82636,88602
2649,48331,"Milam County, Texas",24797,24934,24238,22946,22732,2065
2650,48333,"Mills County, Texas",4877,4887,5151,4531,4477,400
2651,48335,"Mitchell County, Texas",8256,9342,9698,8016,9088,-832
2652,48337,"Montague County, Texas",19640,19789,19117,17274,17410,2230
2653,48339,"Montgomery County, Texas",590188,427717,293768,182201,128487,461701
2654,48341,"Moore County, Texas",21169,21102,20121,17865,16575,4594
2655,48343,"Morris County, Texas",12357,13077,13048,13200,14629,-2272
2656,48345,"Motley County, Texas",1362,1123,1426,1532,1950,-588
2657,48347,"Nacogdoches County, Texas",65080,63141,59203,54753,46786,18294
2658,48349,"Navarro County, Texas",49475,47483,45124,39926,35323,14152
2659,48351,"Newton County, Texas",13788,14389,15072,13569,13254,534
2660,48353,"Nolan County, Texas",14901,14990,15802,16594,17359,-2458
2661,48355,"Nueces County, Texas",362151,334370,313645,291145,268215,93936
2662,48357,"Ochiltree County, Texas",9907,9953,9006,9128,9588,319
2663,48359,"Oldham County, Texas",2110,2020,2185,2278,2283,-173
2664,48361,"Orange County, Texas",83776,82014,84966,80509,83838,-62
2665,48363,"Palo Pinto County, Texas",28792,27927,27026,25055,24062,4730
2666,48365,"Panola County, Texas",23186,23569,22756,22035,20724,2462
2667,48367,"Parker County, Texas",138447,112158,88495,64785,44609,93838
2668,48369,"Parmer County, Texas",9639,10098,10016,9863,11038,-1399
2669,48371,"Pecos County, Texas",15725,15400,16809,14675,14618,1107
2670,48373,"Polk County, Texas",50155,45590,41133,30687,24407,25748
2671,48375,"Potter County, Texas",118323,120124,113546,97874,98637,19686
2672,48377,"Presidio County, Texas",6808,7703,7304,6637,5188,1620
2673,48379,"Rains County, Texas",12001,10942,9139,6715,4839,7162
2674,48381,"Randall County, Texas",136005,116811,104312,89673,75062,60943
2675,48383,"Reagan County, Texas",3766,3298,3326,4514,4135,-369
2676,48385,"Real County, Texas",3429,3279,3047,2412,2469,960
2677,48387,"Red River County, Texas",12115,12987,14314,14317,16101,-3986
2678,48389,"Reeves County, Texas",15546,13269,13137,15852,15801,-255
2679,48391,"Refugio County, Texas",7015,7434,7828,7976,9289,-2274
2680,48393,"Roberts County, Texas",784,877,887,1025,1187,-403
2681,48395,"Robertson County, Texas",17094,16574,16000,15511,14653,2441
2682,48397,"Rockwall County, Texas",101175,73311,43080,25604,14528,86647
2683,48399,"Runnels County, Texas",10280,10492,11495,11294,11872,-1592
2684,48401,"Rusk County, Texas",53988,52016,47372,43735,41382,12606
2685,48403,"Sabine County, Texas",10470,10653,10469,9586,8702,1768
2686,48405,"San Augustine County, Texas",8260,8996,8946,7999,8785,-525
2687,48407,"San Jacinto County, Texas",28574,25859,22246,16372,11434,17140
2688,48409,"San Patricio County, Texas",66969,66100,67138,58749,58013,8956
2689,48411,"San Saba County, Texas",6004,6023,6186,5401,6204,-200
2690,48413,"Schleicher County, Texas",2898,3343,2935,2990,2820,78
2691,48415,"Scurry County, Texas",16918,16579,16361,18634,18192,-1274
2692,48417,"Shackelford County, Texas",3291,3182,3302,3316,3915,-624
2693,48419,"Shelby County, Texas",25263,25423,25224,22034,23084,2179
2694,48421,"Sherman County, Texas",3046,3000,3186,2858,3174,-128
2695,48423,"Smith County, Texas",230184,203393,174706,151309,128366,101818
2696,48425,"Somervell County, Texas",8958,8200,6809,5360,4154,4804
2697,48427,"Starr County, Texas",64032,59989,53597,40518,27266,36766
2698,48429,"Stephens County, Texas",9358,9562,9674,9010,9926,-568
2699,48431,"Sterling County, Texas",1274,1160,1393,1438,1206,68
2700,48433,"Stonewall County, Texas",1412,1434,1693,2013,2406,-994
2701,48435,"Sutton County, Texas",3793,4257,4077,4135,5130,-1337
2702,48437,"Swisher County, Texas",7403,7828,8378,8133,9723,-2320
2703,48439,"Tarrant County, Texas",2077153,1743300,1446219,1170103,860880,1216273
2704,48441,"Taylor County, Texas",137521,129477,126555,119655,110932,26589
2705,48443,"Terrell County, Texas",903,850,1081,1410,1595,-692
2706,48445,"Terry County, Texas",12408,12498,12761,13218,14581,-2173
2707,48447,"Throckmorton County, Texas",1500,1814,1850,1880,2053,-553
2708,48449,"Titus County, Texas",32709,30995,28118,24009,21442,11267
2709,48451,"Tom Green County, Texas",118645,108000,104010,98458,84784,33861
2710,48453,"Travis County, Texas",1250884,979712,812280,576407,419573,831311
2711,48455,"Trinity County, Texas",14689,14451,13779,11445,9450,5239
2712,48457,"Tyler County, Texas",21524,21472,20871,16646,16223,5301
2713,48459,"Upshur County, Texas",41386,38685,35291,31370,28595,12791
2714,48461,"Upton County, Texas",3651,3243,3404,4447,4619,-968
2715,48463,"Uvalde County, Texas",26899,26285,25926,23340,22441,4458
2716,48465,"Val Verde County, Texas",49018,48088,44856,38721,35910,13108
2717,48467,"Van Zandt County, Texas",55970,52362,48140,37944,31426,24544
2718,48469,"Victoria County, Texas",92044,85813,84088,74361,68807,23237
2719,48471,"Walker County, Texas",72295,66353,61758,50917,41789,30506
2720,48473,"Waller County, Texas",53626,40831,32663,23390,19798,33828
2721,48475,"Ward County, Texas",11745,10505,10909,13115,13976,-2231
2722,48477,"Washington County, Texas",35275,32949,30373,26154,21998,13277
2723,48479,"Webb County, Texas",274847,240346,193117,133239,99258,175589
2724,48481,"Wharton County, Texas",41672,41036,41188,39955,40242,1430
2725,48483,"Wheeler County, Texas",5187,5235,5284,5879,7137,-1950
2726,48485,"Wichita County, Texas",132154,130976,131664,122378,121082,11072
2727,48487,"Wilbarger County, Texas",12717,13637,14676,15121,15931,-3214
2728,48489,"Willacy County, Texas",21419,21769,20082,17705,17495,3924
2729,48491,"Williamson County, Texas",570437,391715,249967,139551,76521,493916
2730,48493,"Wilson County, Texas",50110,41264,32408,22650,16756,33354
2731,48495,"Winkler County, Texas",7822,6933,7173,8626,9944,-2122
2732,48497,"Wise County, Texas",67884,58054,48793,34679,26575,41309
2733,48499,"Wood County, Texas",45054,41625,36752,29380,24697,20357
2734,48501,"Yoakum County, Texas",8612,7706,7322,8786,8299,313
2735,48503,"Young County, Texas",17961,18298,17943,18126,19083,-1122
2736,48505,"Zapata County, Texas",14243,13609,12182,9279,6628,7615
2737,48507,"Zavala County, Texas",11930,11658,11600,12162,11666,264
2738,49001,"Beaver County, Utah",6594,6431,6005,4765,4378,2216
2739,49003,"Box Elder County, Utah",54953,48221,42745,36485,33222,21731
2740,49005,"Cache County, Utah",126336,107078,91391,70183,57176,69160
2741,49007,"Carbon County, Utah",20401,20765,20422,20228,22179,-1778
2742,49009,"Daggett County, Utah",590,839,921,690,769,-179
2743,49011,"Davis County, Utah",350761,294532,238994,187941,146540,204221
2744,49013,"Duchesne County, Utah",19950,17408,14371,12645,12565,7385
2745,49015,"Emery County, Utah",10099,10728,10860,10332,11451,-1352
2746,49017,"Garfield County, Utah",5000,4958,4735,3980,3673,1327
2747,49019,"Grand County, Utah",9698,8987,8485,6620,8241,1457
2748,49021,"Iron County, Utah",53148,44439,33779,20789,17349,35799
2749,49023,"Juab County, Utah",11623,9855,8238,5817,5530,6093
2750,49025,"Kane County, Utah",7658,6893,6046,5169,4024,3634
2751,49027,"Millard County, Utah",12963,12189,12405,11333,8970,3993
2752,49029,"Morgan County, Utah",11950,9013,7129,5528,4917,7033
2753,49031,"Piute County, Utah",1870,1661,1435,1277,1329,541
2754,49033,"Rich County, Utah",2415,2181,1961,1725,2100,315
2755,49035,"Salt Lake County, Utah",1146215,1000155,898387,725956,619066,527149
2756,49037,"San Juan County, Utah",15295,14299,14413,12621,12253,3042
2757,49039,"Sanpete County, Utah",30421,26651,22763,16259,14620,15801
2758,49041,"Sevier County, Utah",21475,20438,18842,15431,14727,6748
2759,49043,"Summit County, Utah",41680,35295,29736,15518,10198,31482
2760,49045,"Tooele County, Utah",69740,55398,40735,26601,26033,43707
2761,49047,"Uintah County, Utah",35736,30991,25224,22211,20506,15230
2762,49049,"Utah County, Utah",621506,486067,368536,263590,218106,403400
2763,49051,"Wasatch County, Utah",33053,22176,15215,10089,8523,24530
2764,49053,"Washington County, Utah",172127,134033,90354,48560,26065,146062
2765,49055,"Wayne County, Utah",2698,2706,2509,2177,1911,787
2766,49057,"Weber County, Utah",255284,222849,196533,158330,144616,110668
2767,50001,"Addison County, Vermont",36947,36841,35974,32953,29406,7541
2768,50003,"Bennington County, Vermont",35649,37122,36994,35845,33345,2304
2769,50005,"Caledonia County, Vermont",30027,31214,29702,27846,25808,4219
2770,50007,"Chittenden County, Vermont",163414,154729,146571,131761,115534,47880
2771,50009,"Essex County, Vermont",6179,6359,6459,6405,6313,-134
2772,50011,"Franklin County, Vermont",49275,47547,45417,39980,34788,14487
2773,50013,"Grand Isle County, Vermont",7075,7105,6901,5318,4613,2462
2774,50015,"Lamoille County, Vermont",25376,24040,23233,19735,16767,8609
2775,50017,"Orange County, Vermont",28873,29059,28226,26149,22739,6134
2776,50019,"Orleans County, Vermont",26843,27256,26277,24053,23440,3403
2777,50021,"Rutland County, Vermont",58527,62278,63400,62142,58347,180
2778,50023,"Washington County, Vermont",58336,59379,58039,54928,52393,5943
2779,50025,"Windham County, Vermont",42628,44438,44216,41588,36933,5695
2780,50027,"Windsor County, Vermont",55191,56891,57418,54055,51030,4161
2781,51001,"Accomack County, Virginia",32560,34066,38305,31703,31268,1292
2782,51003,"Albemarle County, Virginia",108819,96633,79236,68040,55783,53036
2783,51005,"Alleghany County, Virginia",15030,16406,12926,13176,14333,697
2784,51007,"Amelia County, Virginia",12970,12517,11400,8787,8405,4565
2785,51009,"Amherst County, Virginia",31782,32315,31894,28578,29122,2660
2786,51011,"Appomattox County, Virginia",15814,14653,13705,12298,11971,3843
2787,51013,"Arlington County, Virginia",236434,197467,189453,170936,152599,83835
2788,51015,"Augusta County, Virginia",75754,73201,65615,54677,53732,22022
2789,51017,"Bath County, Virginia",4248,4779,5048,4799,5860,-1612
2790,51019,"Bedford County, Virginia",78965,67697,60371,45656,34927,44038
2791,51021,"Bland County, Virginia",6334,6873,6871,6514,6349,-15
2792,51023,"Botetourt County, Virginia",33440,32867,30496,24992,23270,10170
2793,51025,"Brunswick County, Virginia",16336,17707,18419,15987,15632,704
2794,51027,"Buchanan County, Virginia",21374,24459,26978,31333,37989,-16615
2795,51029,"Buckingham County, Virginia",17087,16874,15623,12873,11751,5336
2796,51031,"Campbell County, Virginia",55406,54174,51078,47572,45424,9982
2797,51033,"Caroline County, Virginia",30581,27844,22121,19217,17904,12677
2798,51035,"Carroll County, Virginia",29911,29985,29245,26594,27270,2641
2799,51036,"Charles City County, Virginia",6965,7205,6926,6282,6692,273
2800,51037,"Charlotte County, Virginia",11953,12644,12472,11688,12266,-313
2801,51041,"Chesterfield County, Virginia",348500,308633,259903,209274,141372,207128
2802,51043,"Clarke County, Virginia",14498,14013,12652,12101,9965,4533
2803,51045,"Craig County, Virginia",5103,5173,5091,4372,3948,1155
2804,51047,"Culpeper County, Virginia",51935,45749,34262,27791,22620,29315
2805,51049,"Cumberland County, Virginia",9869,9855,9017,7825,7881,1988
2806,51051,"Dickenson County, Virginia",14524,15966,16395,17620,19806,-5282
2807,51053,"Dinwiddie County, Virginia",28686,27449,24533,20960,22602,6084
2808,51057,"Essex County, Virginia",10960,10901,9989,8689,8864,2096
2809,51059,"Fairfax County, Virginia",1149439,1048554,969749,818584,596901,552538
2810,51061,"Fauquier County, Virginia",70353,64546,55139,48741,35889,34464
2811,51063,"Floyd County, Virginia",15766,15030,13874,12005,11563,4203
2812,51065,"Fluvanna County, Virginia",26873,25308,20047,12429,10244,16629
2813,51067,"Franklin County, Virginia",56231,54938,47286,39549,35740,20491
2814,51069,"Frederick County, Virginia",88054,75835,59209,45723,34150,53904
2815,51071,"Giles County, Virginia",16760,17205,16657,16366,17810,-1050
2816,51073,"Gloucester County, Virginia",37362,36610,34780,30131,20107,17255
2817,51075,"Goochland County, Virginia",23472,21136,16863,14163,11761,11711
2818,51077,"Grayson County, Virginia",15651,15855,17917,16278,16579,-928
2819,51079,"Greene County, Virginia",19734,18082,15244,10297,7625,12109
2820,51081,"Greensville County, Virginia",11403,12181,11560,8853,10903,500
2821,51083,"Halifax County, Virginia",34295,36311,37355,29033,30599,3696
2822,51085,"Hanover County, Virginia",106538,99172,86320,63306,50398,56140
2823,51087,"Henrico County, Virginia",330076,300053,262300,217881,180735,149341
2824,51089,"Henry County, Virginia",51032,54860,57930,56942,57654,-6622
2825,51091,"Highland County, Virginia",2202,2395,2536,2635,2937,-735
2826,51093,"Isle Of Wight County, Virginia",37107,34762,29728,25053,21603,15504
2827,51095,"James City County, Virginia",76032,64386,48102,34859,22763,53269
2828,51097,"King And Queen County, Virginia",7011,6926,6630,6289,5968,1043
2829,51099,"King George County, Virginia",26679,22794,16803,13527,10543,16136
2830,51101,"King William County, Virginia",16985,15509,13146,10913,9334,7651
2831,51103,"Lancaster County, Virginia",10686,11478,11567,10896,10129,557
2832,51105,"Lee County, Virginia",23723,25434,23589,24496,25956,-2233
2833,51107,"Loudoun County, Virginia",405312,291653,169599,86129,57427,347885
2834,51109,"Louisa County, Virginia",36654,32248,25627,20325,17825,18829
2835,51111,"Lunenburg County, Virginia",12294,12968,13146,11419,12124,170
2836,51113,"Madison County, Virginia",13208,13342,12520,11949,10232,2976
2837,51115,"Mathews County, Virginia",8760,9004,9207,8348,7995,765
2838,51117,"Mecklenburg County, Virginia",30726,32774,32380,29241,29444,1282
2839,51119,"Middlesex County, Virginia",10642,10831,9932,8653,7719,2923
2840,51121,"Montgomery County, Virginia",98495,92527,83629,73913,63516,34979
2841,51125,"Nelson County, Virginia",14812,14989,14445,12778,12204,2608
2842,51127,"New Kent County, Virginia",22310,17655,13462,10445,8781,13529
2843,51131,"Northampton County, Virginia",11826,12572,13093,13061,14625,-2799
2844,51133,"Northumberland County, Virginia",12151,12419,12259,10524,9828,2323
2845,51135,"Nottoway County, Virginia",15338,15819,15725,14993,14666,672
2846,51137,"Orange County, Virginia",36501,32730,25881,21421,18063,18438
2847,51139,"Page County, Virginia",23862,24116,23177,21690,19401,4461
2848,51141,"Patrick County, Virginia",17660,18643,19407,17473,17647,13
2849,51143,"Pittsylvania County, Virginia",60867,63147,61745,55655,66147,-5280
2850,51145,"Powhatan County, Virginia",29253,27758,22377,15328,13062,16191
2851,51147,"Prince Edward County, Virginia",22892,22723,19720,17320,16456,6436
2852,51149,"Prince George County, Virginia",38292,35129,33047,27394,25733,12559
2853,51153,"Prince William County, Virginia",466834,379415,280813,215686,144703,322131
2854,51155,"Pulaski County, Virginia",34113,34963,35127,34496,35229,-1116
2855,51157,"Rappahannock County, Virginia",7360,7376,6983,6622,6093,1267
2856,51159,"Richmond County, Virginia",8951,9328,8809,7273,6952,1999
2857,51161,"Roanoke County, Virginia",94103,91583,85778,79332,72945,21158
2858,51163,"Rockbridge County, Virginia",22728,22217,20808,18350,17911,4817
2859,51165,"Rockingham County, Virginia",81138,74922,67725,57482,57038,24100
2860,51167,"Russell County, Virginia",26937,28842,30308,28667,31761,-4824
2861,51169,"Scott County, Virginia",21761,23234,23403,23204,25068,-3307
2862,51171,"Shenandoah County, Virginia",43441,41468,35075,31636,27559,15882
2863,51173,"Smyth County, Virginia",30539,32383,33081,32370,33366,-2827
2864,51175,"Southampton County, Virginia",17829,18493,17482,17550,18731,-902
2865,51177,"Spotsylvania County, Virginia",134683,120212,90395,57403,34435,100248
2866,51179,"Stafford County, Virginia",150185,124587,92446,61236,40470,109715
2867,51181,"Surry County, Virginia",6459,7039,6829,6145,6046,413
2868,51183,"Sussex County, Virginia",11202,12167,12504,10248,10874,328
2869,51185,"Tazewell County, Virginia",41201,44706,44598,45960,50511,-9310
2870,51187,"Warren County, Virginia",39888,37044,31584,26142,21200,18688
2871,51191,"Washington County, Virginia",54005,54322,51103,45887,46487,7518
2872,51193,"Westmoreland County, Virginia",17873,17237,16718,15480,14041,3832
2873,51195,"Wise County, Virginia",38032,41496,40123,39573,43863,-5831
2874,51197,"Wythe County, Virginia",28725,29005,27599,25466,25522,3203
2875,51199,"York County, Virginia",68389,64846,56297,42422,35463,32926
2876,51510,"Alexandria City, Virginia",158309,133647,128283,111183,103217,55092
2877,51520,"Bristol City, Virginia",17059,17704,17367,18426,19042,-1983
2878,51530,"Buena Vista City, Virginia",6477,6653,6349,6406,6717,-240
2879,51540,"Charlottesville City, Virginia",47217,42267,45049,40341,39916,7301
2880,51550,"Chesapeake City, Virginia",242647,219268,199184,151976,114486,128161
2881,51570,"Colonial Heights City, Virginia",17283,17472,16897,16064,16509,774
2882,51580,"Covington City, Virginia",5653,5989,6303,6991,9063,-3410
2883,51590,"Danville City, Virginia",40668,43787,48411,53056,45642,-4974
2884,51595,"Emporia City, Virginia",5408,5822,5665,5306,4840,568
2885,51600,"Fairfax City, Virginia",23312,22058,21498,19622,19390,3922
2886,51610,"Falls Church City, Virginia",14309,11465,10377,9578,9515,4794
2887,51620,"Franklin City, Virginia",8015,8549,8346,7864,7308,707
2888,51630,"Fredericksburg City, Virginia",29059,23375,19279,19027,15322,13737
2889,51640,"Galax City, Virginia",6402,6936,6837,6670,6524,-122
2890,51650,"Hampton City, Virginia",135169,139046,146437,133793,122617,12552
2891,51660,"Harrisonburg City, Virginia",53558,47406,40468,30707,19671,33887
2892,51670,"Hopewell City, Virginia",22500,22506,22354,23101,23397,-897
2893,51678,"Lexington City, Virginia",7205,6990,6867,6959,7292,-87
2894,51680,"Lynchburg City, Virginia",80970,73726,65269,66049,66743,14227
2895,51683,"Manassas City, Virginia",41038,36067,35135,27957,15438,25600
2896,51685,"Manassas Park City, Virginia",17548,13195,10290,6734,6524,11024
2897,51690,"Martinsville City, Virginia",12646,14029,15416,16162,18149,-5503
2898,51700,"Newport News City, Virginia",179582,181822,180150,170045,144903,34679
2899,51710,"Norfolk City, Virginia",244300,242143,234403,261229,266979,-22679
2900,51720,"Norton City, Virginia",3969,3886,3904,4247,4757,-788
2901,51730,"Petersburg City, Virginia",30791,32303,33740,38386,41055,-10264
2902,51735,"Poquoson City, Virginia",12121,12099,11566,11005,8726,3395
2903,51740,"Portsmouth City, Virginia",94961,96785,100565,103907,104577,-9616
2904,51750,"Radford City, Virginia",17833,16318,15859,15940,13225,4608
2905,51760,"Richmond City, Virginia",229233,201828,197790,203056,219214,10019
2906,51770,"Roanoke City, Virginia",99122,95793,94911,96397,100220,-1098
2907,51775,"Salem City, Virginia",25290,24641,24747,23756,23958,1332
2908,51790,"Staunton City, Virginia",24660,23806,23853,24461,21857,2803
2909,51800,"Suffolk City, Virginia",91383,82544,63677,52141,47621,43762
2910,51810,"Virginia Beach City, Virginia",450882,435996,425257,393069,262199,188683
2911,51820,"Waynesboro City, Virginia",22300,20885,19520,18549,15329,6971
2912,51830,"Williamsburg City, Virginia",15034,13421,11998,11530,9870,5164
2913,51840,"Winchester City, Virginia",27912,25953,23585,21947,20217,7695
2914,53001,"Adams County, Washington",19702,17884,16428,13603,13267,6435
2915,53003,"Asotin County, Washington",22636,21363,20551,17605,16823,5813
2916,53005,"Benton County, Washington",200715,167077,142475,112560,109444,91271
2917,53007,"Chelan County, Washington",76653,70995,66616,52250,45061,31592
2918,53009,"Clallam County, Washington",76482,70638,64525,56464,51648,24834
2919,53011,"Clark County, Washington",481950,414816,345238,238053,192227,289723
2920,53013,"Columbia County, Washington",4024,3957,4064,4024,4057,-33
2921,53015,"Cowlitz County, Washington",108399,101244,92948,82119,79548,28851
2922,53017,"Douglas County, Washington",42520,37160,32603,26205,22144,20376
2923,53019,"Ferry County, Washington",7643,7504,7260,6295,5811,1832
2924,53021,"Franklin County, Washington",93681,71329,49347,37473,35025,58656
2925,53023,"Garfield County, Washington",2258,2240,2397,2248,2468,-210
2926,53025,"Grant County, Washington",96648,85142,74698,54758,48522,48126
2927,53027,"Grays Harbor County, Washington",73769,72092,67194,64175,66314,7455
2928,53029,"Island County, Washington",84187,78633,71558,60195,44048,40139
2929,53031,"Jefferson County, Washington",31825,29574,25953,20146,15965,15860
2930,53033,"King County, Washington",2225064,1879189,1737034,1507319,1269749,955315
2931,53035,"Kitsap County, Washington",268945,247336,231969,189731,147152,121793
2932,53037,"Kittitas County, Washington",47097,39869,33362,26725,24877,22220
2933,53039,"Klickitat County, Washington",22055,20055,19161,16616,15822,6233
2934,53041,"Lewis County, Washington",79430,74650,68600,59358,56025,23405
2935,53043,"Lincoln County, Washington",10732,10533,10184,8864,9604,1128
2936,53045,"Mason County, Washington",65326,59287,49405,38341,31184,34142
2937,53047,"Okanogan County, Washington",42080,40238,39564,33350,30639,11441
2938,53049,"Pacific County, Washington",22121,21192,20984,18882,17237,4884
2939,53051,"Pend Oreille County, Washington",13588,12904,11732,8915,8580,5008
2940,53053,"Pierce County, Washington",891862,782681,700820,586203,485643,406219
2941,53055,"San Juan County, Washington",16953,15551,14077,10035,7838,9115
2942,53057,"Skagit County, Washington",127442,115231,102979,79555,64138,63304
2943,53059,"Skamania County, Washington",11906,10869,9872,8289,7919,3987
2944,53061,"Snohomish County, Washington",811572,694219,606024,465642,337720,473852
2945,53063,"Spokane County, Washington",513402,461262,417939,361364,341835,171567
2946,53065,"Stevens County, Washington",45233,43171,40066,30948,28979,16254
2947,53067,"Thurston County, Washington",284698,243563,207355,161238,124264,160434
2948,53069,"Wahkiakum County, Washington",4318,3982,3824,3327,3832,486
2949,53071,"Walla Walla County, Washington",60785,57585,55180,48439,47435,13350
2950,53073,"Whatcom County, Washington",224538,195993,166814,127780,106701,117837
2951,53075,"Whitman County, Washington",49577,43747,40740,38775,40103,9474
2952,53077,"Yakima County, Washington",250649,236542,222581,188823,172508,78141
2953,54001,"Barbour County, West Virginia",16543,16256,15557,15699,16639,-96
2954,54003,"Berkeley County, West Virginia",117615,100910,75905,59253,46775,70840
2955,54005,"Boone County, West Virginia",21897,24872,25535,25870,30447,-8550
2956,54007,"Braxton County, West Virginia",14032,14558,14702,12998,13894,138
2957,54009,"Brooke County, West Virginia",22162,24194,25447,26992,31117,-8955
2958,54011,"Cabell County, West Virginia",93328,95526,96784,96827,106835,-13507
2959,54013,"Calhoun County, West Virginia",7185,7588,7582,7885,8250,-1065
2960,54015,"Clay County, West Virginia",8599,9572,10330,9983,11265,-2666
2961,54017,"Doddridge County, West Virginia",8499,8035,7403,6994,7433,1066
2962,54019,"Fayette County, West Virginia",43087,46138,47579,47952,57863,-14776
2963,54021,"Gilmer County, West Virginia",7970,8394,7160,7669,8334,-364
2964,54023,"Grant County, West Virginia",11565,11942,11299,10428,10210,1355
2965,54025,"Greenbrier County, West Virginia",34893,35373,34453,34693,37665,-2772
2966,54027,"Hampshire County, West Virginia",23304,23594,20203,16498,14867,8437
2967,54029,"Hancock County, West Virginia",29118,30866,32667,35233,40418,-11300
2968,54031,"Hardy County, West Virginia",13789,13832,12669,10977,10030,3759
2969,54033,"Harrison County, West Virginia",67620,68490,68652,69371,77710,-10090
2970,54035,"Jackson County, West Virginia",28793,29084,28000,25938,25794,2999
2971,54037,"Jefferson County, West Virginia",56922,52033,42190,35926,30302,26620
2972,54039,"Kanawha County, West Virginia",181014,192770,200073,207619,231414,-50400
2973,54041,"Lewis County, West Virginia",16024,16406,16919,17223,18813,-2789
2974,54043,"Lincoln County, West Virginia",20617,21879,22108,21382,23675,-3058
2975,54045,"Logan County, West Virginia",32593,36564,37710,43032,50679,-18086
2976,54047,"Mcdowell County, West Virginia",18083,22555,27329,35233,49899,-31816
2977,54049,"Marion County, West Virginia",56233,56356,56598,57249,65789,-9556
2978,54051,"Marshall County, West Virginia",30900,33369,35519,37356,41608,-10708
2979,54053,"Mason County, West Virginia",26700,27016,25957,25178,27045,-345
2980,54055,"Mercer County, West Virginia",59370,61844,62980,64980,73942,-14572
2981,54057,"Mineral County, West Virginia",27047,27796,27078,26697,27234,-187
2982,54059,"Mingo County, West Virginia",23808,26956,28253,33739,37336,-13528
2983,54061,"Monongalia County, West Virginia",106196,92715,81866,75509,75024,31172
2984,54063,"Monroe County, West Virginia",13344,13495,14583,12406,12873,471
2985,54065,"Morgan County, West Virginia",17800,17409,14943,12128,10711,7089
2986,54067,"Nicholas County, West Virginia",24857,26189,26562,26775,28126,-3269
2987,54069,"Ohio County, West Virginia",41875,44582,47427,50871,61389,-19514
2988,54071,"Pendleton County, West Virginia",6968,7773,8196,8054,7910,-942
2989,54073,"Pleasants County, West Virginia",7457,7664,7514,7546,8236,-779
2990,54075,"Pocahontas County, West Virginia",8382,8808,9131,9008,9919,-1537
2991,54077,"Preston County, West Virginia",33610,32976,29334,29037,30460,3150
2992,54079,"Putnam County, West Virginia",56604,54940,51589,42835,38181,18423
2993,54081,"Raleigh County, West Virginia",74452,78513,79220,76819,86821,-12369
2994,54083,"Randolph County, West Virginia",28763,29233,28262,27803,28734,29
2995,54085,"Ritchie County, West Virginia",9747,10514,10343,10233,11442,-1695
2996,54087,"Roane County, West Virginia",13831,15116,15446,15120,15952,-2121
2997,54089,"Summers County, West Virginia",12710,13847,12999,14204,15875,-3165
2998,54091,"Taylor County, West Virginia",16817,16732,16089,15144,16584,233
2999,54093,"Tucker County, West Virginia",6943,7137,7321,7728,8675,-1732
3000,54095,"Tyler County, West Virginia",8736,9339,9592,9796,11320,-2584
3001,54097,"Upshur County, West Virginia",24451,23984,23404,22867,23427,1024
3002,54099,"Wayne County, West Virginia",39952,42647,42903,41636,46021,-6069
3003,54101,"Webster County, West Virginia",8289,9247,9719,10729,12245,-3956
3004,54103,"Wetzel County, West Virginia",15291,16697,17693,19258,21874,-6583
3005,54105,"Wirt County, West Virginia",5764,5753,5873,5192,4922,842
3006,54107,"Wood County, West Virginia",84387,86731,87986,86915,93648,-9261
3007,54109,"Wyoming County, West Virginia",20890,23993,25708,28990,35993,-15103
3008,55001,"Adams County, Wisconsin",20208,21044,18643,15682,13457,6751
3009,55003,"Ashland County, Wisconsin",15524,16212,16866,16307,16783,-1259
3010,55005,"Barron County, Wisconsin",45182,45915,44963,40750,38730,6452
3011,55007,"Bayfield County, Wisconsin",15088,15114,15013,14008,13822,1266
3012,55009,"Brown County, Wisconsin",262559,244376,226778,194594,175280,87279
3013,55011,"Buffalo County, Wisconsin",13087,13744,13804,13584,14309,-1222
3014,55013,"Burnett County, Wisconsin",15363,15749,15674,13084,12340,3023
3015,55015,"Calumet County, Wisconsin",50005,47902,40631,34291,30867,19138
3016,55017,"Chippewa County, Wisconsin",64175,61466,55195,52360,52127,12048
3017,55019,"Clark County, Wisconsin",34668,34552,33557,31647,32910,1758
3018,55021,"Columbia County, Wisconsin",57331,56350,52468,45088,43222,14109
3019,55023,"Crawford County, Wisconsin",16155,16801,17243,15940,16556,-401
3020,55025,"Dane County, Wisconsin",542459,477748,426526,367085,323545,218914
3021,55027,"Dodge County, Wisconsin",87569,88935,85897,76559,75064,12505
3022,55029,"Door County, Wisconsin",27621,27959,27961,25690,25029,2592
3023,55031,"Douglas County, Wisconsin",43497,43907,43287,41758,44421,-924
3024,55033,"Dunn County, Wisconsin",45029,43365,39858,35909,34314,10715
3025,55035,"Eau Claire County, Wisconsin",104132,97381,93142,85183,78805,25327
3026,55037,"Florence County, Wisconsin",4312,4587,5088,4590,4172,140
3027,55039,"Fond Du Lac County, Wisconsin",102654,100919,97296,90083,88964,13690
3028,55041,"Forest County, Wisconsin",9003,9534,10024,8776,9044,-41
3029,55043,"Grant County, Wisconsin",51570,50716,49597,49264,51736,-166
3030,55045,"Green County, Wisconsin",36790,36448,33647,30339,30012,6778
3031,55047,"Green Lake County, Wisconsin",18807,19107,19105,18651,18370,437
3032,55049,"Iowa County, Wisconsin",23632,23646,22780,20150,19802,3830
3033,55051,"Iron County, Wisconsin",5679,6075,6861,6153,6730,-1051
3034,55053,"Jackson County, Wisconsin",20556,20284,19100,16588,16831,3725
3035,55055,"Jefferson County, Wisconsin",84837,82778,74021,67783,66152,18685
3036,55057,"Juneau County, Wisconsin",26603,26733,24316,21650,21039,5564
3037,55059,"Kenosha County, Wisconsin",168998,164328,149577,128181,123137,45861
3038,55061,"Kewaunee County, Wisconsin",20398,20642,20187,18878,19539,859
3039,55063,"La Crosse County, Wisconsin",118168,112819,107120,97904,91056,27112
3040,55065,"Lafayette County, Wisconsin",16682,16775,16137,16076,17412,-730
3041,55067,"Langlade County, Wisconsin",19167,20218,20740,19505,19978,-811
3042,55069,"Lincoln County, Wisconsin",27687,29075,29641,26993,26555,1132
3043,55071,"Manitowoc County, Wisconsin",78977,81678,82887,80421,82918,-3941
3044,55073,"Marathon County, Wisconsin",135485,132644,125834,115400,111270,24215
3045,55075,"Marinette County, Wisconsin",40312,42019,43384,40548,39314,998
3046,55077,"Marquette County, Wisconsin",15380,15421,15832,12321,11672,3708
3047,55078,"Menominee County, Wisconsin",4566,4251,4562,3890,3373,1193
3048,55079,"Milwaukee County, Wisconsin",949180,937616,940164,959275,964988,-15808
3049,55081,"Monroe County, Wisconsin",46155,44053,40899,36633,35074,11081
3050,55083,"Oconto County, Wisconsin",37870,37737,35634,30226,28947,8923
3051,55085,"Oneida County, Wisconsin",35480,36379,36776,31679,31216,4264
3052,55087,"Outagamie County, Wisconsin",186829,174457,160971,140510,128799,58030
3053,55089,"Ozaukee County, Wisconsin",89179,85945,82317,72831,66981,22198
3054,55091,"Pepin County, Wisconsin",7261,7517,7213,7107,7477,-216
3055,55093,"Pierce County, Wisconsin",42336,40530,36804,32765,31149,11187
3056,55095,"Polk County, Wisconsin",43549,44310,41319,34773,32351,11198
3057,55097,"Portage County, Wisconsin",70822,69437,67182,61405,57420,13402
3058,55099,"Price County, Wisconsin",13351,14452,15822,15600,15788,-2437
3059,55101,"Racine County, Wisconsin",195859,194736,188831,175034,173132,22727
3060,55103,"Richland County, Wisconsin",17408,18205,17924,17521,17476,-68
3061,55105,"Rock County, Wisconsin",162532,159964,152307,139510,139420,23112
3062,55107,"Rusk County, Wisconsin",14074,14855,15347,15079,15589,-1515
3063,55109,"St. Croix County, Wisconsin",89702,82636,63155,50251,43262,46440
3064,55111,"Sauk County, Wisconsin",64152,60957,55225,46975,43469,20683
3065,55113,"Sawyer County, Wisconsin",16477,16615,16196,14181,12843,3634
3066,55115,"Shawano County, Wisconsin",40813,41842,40664,37157,35928,4885
3067,55117,"Sheboygan County, Wisconsin",115152,115328,112646,103877,100935,14217
3068,55119,"Taylor County, Wisconsin",20320,20557,19680,18901,18817,1503
3069,55121,"Trempealeau County, Wisconsin",29525,28523,27010,25263,26158,3367
3070,55123,"Vernon County, Wisconsin",30759,29460,28056,25617,25642,5117
3071,55125,"Vilas County, Wisconsin",21923,21750,21033,17707,16535,5388
3072,55127,"Walworth County, Wisconsin",103391,101735,93759,75000,71507,31884
3073,55129,"Washburn County, Wisconsin",15726,16001,16036,13772,13174,2552
3074,55131,"Washington County, Wisconsin",135529,130206,117493,95328,84848,50681
3075,55133,"Waukesha County, Wisconsin",402637,386130,360767,304715,280326,122311
3076,55135,"Waupaca County, Wisconsin",50997,52533,51731,46104,42831,8166
3077,55137,"Waushara County, Wisconsin",24256,24631,23154,19385,18526,5730
3078,55139,"Winnebago County, Wisconsin",170924,165032,156763,140320,131703,39221
3079,55141,"Wood County, Wisconsin",72892,74601,75555,73605,72799,93
3080,56001,"Albany County, Wyoming",38664,34926,32014,30797,29062,9602
3081,56003,"Big Horn County, Wyoming",11809,11448,11461,10525,11896,-87
3082,56005,"Campbell County, Wyoming",46958,43179,33698,29370,24367,22591
3083,56007,"Carbon County, Wyoming",15073,15624,15639,16659,21896,-6823
3084,56009,"Converse County, Wyoming",13842,13404,12052,11128,14069,-227
3085,56011,"Crook County, Wyoming",7502,6761,5887,5294,5308,2194
3086,56013,"Fremont County, Wyoming",39711,38875,35804,33662,38992,719
3087,56015,"Goshen County, Wyoming",13301,12844,12538,12373,12040,1261
3088,56017,"Hot Springs County, Wyoming",4550,4720,4882,4809,5710,-1160
3089,56019,"Johnson County, Wyoming",8518,8307,7075,6145,6700,1818
3090,56021,"Laramie County, Wyoming",99272,89221,81607,73142,68649,30623
3091,56023,"Lincoln County, Wyoming",19640,17447,14573,12625,12177,7463
3092,56025,"Natrona County, Wyoming",80067,73520,66533,61226,71856,8211
3093,56027,"Niobrara County, Wyoming",2377,2430,2407,2499,2924,-547
3094,56029,"Park County, Wyoming",29273,27574,25786,23178,21639,7634
3095,56031,"Platte County, Wyoming",8572,8655,8807,8145,11975,-3403
3096,56033,"Sheridan County, Wyoming",30397,28380,26560,23562,25048,5349
3097,56035,"Sublette County, Wyoming",9865,9322,5920,4843,4548,5317
3098,56037,"Sweetwater County, Wyoming",43352,42266,37613,38823,41723,1629
3099,56039,"Teton County, Wyoming",23356,20802,18251,11172,9355,14001
3100,56041,"Uinta County, Wyoming",20374,20537,19742,18705,13021,7353
3101,56043,"Washakie County, Wyoming",7933,8271,8289,8388,9496,-1563
3102,56045,"Weston County, Wyoming",6942,7066,6644,6518,7106,-164
